abil_skill_summonvoidcrystal_name	無の水晶召喚
boost_stat_level_up_var	<color=yellow>^tag2^</color> <color=#0cffe6>^tag1^</color>を獲得した！
boostattack_after_move_desc	次の近接攻撃の与ダメージが^number1^
calligrapherskill50_desc	書道家のスキルダメージ ^number1^
des_obj_confusetrap_dname	混乱の罠
description_escapeportal_shara	特定のサイドエリアから各地へ瞬時に移動できます。
dialog_comparerelic_txt	<size=50>^$getstring:leg_origname$^（ランク変動型）</size>\n\n<color=#ffc80a>伝説アイテム（^$getstring:leg_origtype$^）</color>\n\n^$getstring:scaledleg_info$^\n
dialog_friendly_dirtbeak_shara_1	#cy#*コケーッ*#ec#、おまえは何者だ？！ずかずかと我が縄張りへ入り込んでくるとは、厚かましいヤツめ！吾輩は#cy#バードボーイズ#ec#のリーダー...というか最強の鳥サマ、#cy#ダートビーク公爵#ec#であるぞ！そういうわけでだな...今すぐ...\n\n
dialog_friendly_dirtbeak_shara_1_response	今すぐ何なの？
dialog_friendly_dirtbeak_shara_2	思うに...吾輩は牙を収めるとしよう。なぜなら吾輩は優しさにおいても、#cy#最強の鳥サマ#ec#であるからだ。#cy#吾輩の巣#ec#でチュンチュン浮かれ騒いでいるバカどもとは、ラベルがちがうのだ！\n\n
dialog_friendly_dirtbeak_shara_2_response	そのバカどもに家を追い出されたの？
dialog_friendly_dirtbeak_shara_3	吾輩はタングルディープで最大最凶の鳥サマであるぞ！ところがバードボーイズの一羽がだな、すべてがくっついた、#cc#へんてこりんな紙の束#ec#を見つけてな。他のボーイズどもにはそいつが読め...というか、とにかくだな！こうした紙は#cy#バカげている#ec#のだ。\n\nそしてこのバカげた紙のせいで、ボーイズどもが...みん...しゅ..しゅぎ？とかいうモノについて、ピーチクパーチク騒ぎ始めたのだ。しまいにはリーダーを#cy#投票#ec#で決めたいと言ってな！\n\n
dialog_friendly_dirtbeak_shara_3_response	だったら、みんな愚か者ね！
dialog_friendly_dirtbeak_shara_4	私もあなたと同じ。利己的な者たちの手で、故郷を追い出されたの。そしてあなたもまた、#cy#強さと信念#ec#を兼ね備えた、リーダーの心を持っているのが見える。私があなたの誇りを取り戻させてあげる。#cy#ふたりで力を合わせて#ec#、気取った言葉が無意味であることを奴らに教えてやりましょう！\n\n
dialog_friendly_dirtbeak_shara_5	コケーッ！そんな優しい言葉をかけられたのは初めてだ...って、いやその、いつだって吾輩は“最強”の鳥サマではあったがな！そして我々が手を組めば、もっと強くなれるに違いない！共にこの#cy#クソガキどもをぶっ潰してやろうぞ#ec#、#cc#青い鳥#ec#よ！我が巣の前で落ち合うとしよう。\n\n
dialog_friendly_dirtbeak_shara_6	その意気よ、公爵！私のことは#cc#シャラ#ec#と呼んで。私たちはもう友だちよ。誰にも私たちを止められない！準備が済んだら、あなたの巣で会いましょう。\n\n
dialog_friendly_dirtbeak_shara_7	おまえの望んだとおり、吾輩と#cy#バードボーイズども#ec#で縄張りを守っておるぞ。\n\n
dialog_learnskill_fromitem_button1_text	スキルを学ぶ（500JP）
dialog_learnskill_fromitem_button2_text	学ばない
dialog_relic_compareoriginal	^$getstring:nonscaled_legtext$^
dialog_relic_found_main_txt	^$getqstring:leg_item$^を<size=50><color=#ffc80a>見つけた</color>！</size>\n\n<color=#ffc80a>伝説アイテム（^$getqstring:leg_type$^）</color>\n\n^$getqstring:leg_info$^\n\n^$getqstring:leg_desc$^\n
dialog_shara_boss1_postfight_1	ま待て、落ち着け！ええと...その、票を数えてみたらですね、どうやらその、あなたがボスで決まりのようです、公爵！\n\n#cy#ピヨピヨピヨ#ec#...\n\n
dialog_shara_boss1_postfight_2	#cr#コケケケーッ！#ec#今笑ったのは誰だ、チビ鳥ども？吾輩は今、#cc#止まり木の公爵#ec#に返り咲いた！#cc#ダートビーク#ec#は#cc#愚かな本#ec#よりもはるかに強いということ、しかと覚えておけい！\n\n
dialog_shara_boss1_postfight_3	では聞け、公爵として最初の新しい指示を与える。我々が盗んできた最高の食料をたっぷりと使って、ごちそうをこしらえてみせよ！なんなら例の愚かな本を使って、たき火の炎を絶やさぬようにな！\n\n
dialog_shara_boss1_postfight_4	こうした食事は久しぶりだわ。ありがとう、ダートビーク。\n\n#cy#公正かつ断固たる権威#ec#を示せば、#cy#ボーイズ#ec#の忠誠心は二度と揺るがない。ボーイズには力が必要よ。あなたの力が。私もそう。\n\n
dialog_shara_boss1_postfight_5	私には長い旅が待っている。いつでも休める場所があれば、負担はずいぶんと和らぐわ。だからこの場所に敵が来ないよう、守っておいてくれる？\n\n
dialog_shara_boss1_postfight_6	任せておけ、#cy#青い鳥#ec#よ！吾輩と#cy#バードボーイズ#ec#が、誰にもおまえを邪魔させないよう力を尽くそう。\n\n#cc#リヴァーストーン村#ec#のコンコンチキどもが現れたらどうする？身ぐるみを剥いどくか？\n
dialog_shara_boss1_postfight_7	必要なことはすべてやって。あなたと#cy#ボーイズ#ec#は常に安全で、お腹が一杯じゃないといけない。#cc#リヴァーストーン#ec#の怠け者たちは、労せずして豊かに暮らしてる。たまには奪われる痛みを教えてあげなきゃ。\n\n油断してはだめよ、#cy#ダートビーク#ec#。私はすぐに戻るから。\n\n
dialog_shara_boss1_postfight_8	ボスはおまえで間違いない！しかしだな、#cy#コケケ#ec#...ひとつだけ言わせてくれ。タングルディープの#cy#盗賊#ec#どもの中には浅はかすぎて、吾輩の極めて寛大かつ強力なリーダーシップに従わん者もいる。というか...吾輩の#cy#バードボーイズ#ec#は今この部屋にいる者で全員なのだよ。\n\nそうであるからして、旅の途中で盗賊に出会っても、ちゅうちょなくぶっ潰してかまわんぞ。吾輩が後からボーイズに引き入れよう！\n\n
dialog_shara_boss1_prefight_1	みんな見ろヨ！#cr#オバカビーク公爵#ec#が、よちよち歩きで戻ってきたゼ！\n\nここにおまえの食いモンはねえし、おまえの指図も必要もねえ！なにせオレたちは、タングルディープで#cy#いっちゃんヤバい盗賊一味#ec#だかんな！\n\n
dialog_shara_boss1_prefight_2	おクチに気をつけるのだな、なぜなら吾輩は今回ひとりではない！わが友人たる#cc#シャラ#ec#と一緒に、貴様らに#cy#敬意#ec#の意味を二、三教えてやろう。
dialog_shara_boss1_prefight_3	あなたたちみんな、周りとは違うってだけで、公爵をのけ者にしてしまうの？公爵の#cy#食欲#ec#も#cy#サイズ#ec#も、本人にはどうにもならないことなのに？\n\n
dialog_shara_boss1_prefight_4	おい、ダートビーク。でっけえことをぶちかますのに、こんな#cr#小娘#ec#を連れてくる必要があったのかヨ？そいつは単なるネズミちゃんにすぎねえ、笑わせんじゃねえゾォ！\n\nわかったら#cr#失せナ#ec#。でないと力ずくで追い返してやんぞ、コラァ！\n\n
dialog_shara_boss1_prefight_5	#cr#コケケケケーッ！#ec#聞いたか、シャラ？！とんでもなく意地悪な奴らだ！\n\n
dialog_shara_boss1_prefight_6	ええ、そのようね。故郷のみんなを思い出すわ。彼らがいかに#cr#無知#ec#だったかを。\n\nあの頃は戦うすべを知らなかったけど...\n\n
dialog_shara_boss1_prefight_7	今はちがう。私がこのおバカさんたちの目を#cg#開かせてあげる#ec#。攻撃よ！\n\n
dialog_shara_boss2_devicedestroyed_1	装置から放たれたエネルギーが、精霊たちを#cr#弱体化#ec#させたわ！始末するチャンスよ！\n\n
dialog_shara_boss2_devicedestroyed_10	インガーソルは勘違いしていた。タングルディープにおける私の人生は、#cr#過酷な選択#ec#の連続だったから。彼の功績をひとつ挙げるとすれば、とある#cy#容易な#ec#選択を、誰にとっても明確にしたこと...\n\n
dialog_shara_boss2_devicedestroyed_11	この世界を修復するため、#cc#女大将#ec#と手を組まない者は皆...#cr#彼#ec#のような最期を迎えるの。\n\n
dialog_shara_boss2_devicedestroyed_2	私の勝ちね。装置は今も残ってる。あなたはフロウの力に値しなかった。いくら小細工しようと、その事実だけは変えられない。\n\n
dialog_shara_boss2_devicedestroyed_3	おまえは予断がすぎるぞ...その装置は...私と一緒に滅びるのだ。おまえは強いが未熟だ。乱れている。#cy#揺るぎない信念#ec#を手に入れたくば、タングルディープの心を真に理解しなければならん。そいつを自ら勝ち取る必要があるだろうが...\n\nおまえにはムリだ...できるはずもない。#cr#おまえには過酷な決断を下せる覚悟がないからな#ec#。タングルディープは想像を絶する怒りを抱えている。#cg#彼#ec#はきっとおまえを滅ぼす... #cg#彼はきっと#ec#...\n\n
dialog_shara_boss2_devicedestroyed_4	あなたの装置は紛いものだった、インガーソル。あなたもまた#cc#フロウ#ec#の支配者かと思ったけど、無様なものね。\n\nあなたはフロウの力に値しない。己を知るのが遅すぎたのよ。\n\n
dialog_shara_boss2_devicedestroyed_5	信念を伴わない力など...無意味だ。たとえ今日勝っても、おまえはタングルディープの真実を理解する前に、#cy#燃え尽きる#ec#だろう。\n\n暴力は安易な手段だが、#cr#おまえには過酷な決断を下せる覚悟がない#ec#。タングルディープは想像を絶する怒りを抱えている。#cg#彼#ec#はきっとおまえを滅ぼす... #cg#彼はきっと#ec#...\n\n
dialog_shara_boss2_devicedestroyed_6	#cy#彼？！彼女？！#ec#それって誰のこと？インガーソル...よくも私に#cr#こんな仕打ち#ec#を！\n\n
dialog_shara_boss2_devicedestroyed_7	テクノロジーを世界へ引き継ぐことなく、破壊してしまうなんて。身勝手すぎるわ。それでも...\n\n
dialog_shara_boss2_devicedestroyed_8	そして装置も破壊されてしまった。誰あろう、インガーソルのせいで。彼の視野が狭すぎたから。それでも...\n\n
dialog_shara_boss2_devicedestroyed_9	これが最後の一体である#cy#はずがない#ec#。インガーソルはこれを作ったのではなく、#cy#発見した#ec#だけ。だとしたら、似たような装置がたくさん見つかっても不思議はない。そして私はインガーソルのように、新たに手に入れた力を#cy#無駄#ec#にはしない。\n\n
dialog_shara_boss3victory_part1_1	#cr#重大なシステムエラー - シャットダウン不可避#ec#\n\n#cy##ec##cg#監督者#ec##cy#への通知を試行中...#ec#\n\n
dialog_shara_boss3victory_part1_10	けどまずは...\n\nこの魔法の鎧さんが、どんなお宝を残していったか確かめなきゃね？\n\n
dialog_shara_boss3victory_part1_11	ここにフロウの導管が...小さな水晶も...うーん...\n\nこのエネルギーは...なぜだか歪んでる。奇妙ね。\n\nそれでも...\n\n
dialog_shara_boss3victory_part1_12	#cg#監督者#ec#がこうした鋼鉄のマシンを操れるなら、私もきっとこの力を使って、#cy#他の者たち#ec#を#cr#従わせられる#ec#はず...\n\n
dialog_shara_boss3victory_part1_13	ピコピコ...\n\nピコピコビー、ピコピコ？\n\n
dialog_shara_boss3victory_part1_14	ビービー？\n\nビービーピコピコビー！\n\nビービー？\n\n
dialog_shara_boss3victory_part1_15	そうよ、触手の生えた鉄の小鳥さん。\n\n私があなたの新しい親友よ。\n\n
dialog_shara_boss3victory_part1_16	完ぺきだわ。\n\n
dialog_shara_boss3victory_part1_2	#cg#監督者#ec#？それって誰なの？誰に命令されているの？！\n\n
dialog_shara_boss3victory_part1_3	#cg#監督者オーバーライド有効#ec#\n\n#cr#自爆しマス...#ec#
dialog_shara_boss3victory_part1_4	待って！#cr#やめて！#ec#\n\n
dialog_shara_boss3victory_part1_5	#cg#監督者#ec#は自身の創造物を私に取られるよりも、破壊することを望んだ。インガーソルと同じように。\n\n今なら彼の言ったことがわかる。これだけの犠牲を伴うなら...きっと圧倒的な力のはず。\n\n
dialog_shara_boss3victory_part1_6	そう、#cy#まさに#ec#圧倒的！私は金属の魔法に囲まれている。知性や生命を宿したマシン？無から物体を生み出せる？\n\nそれって#cg#神々#ec#の力だわ。\n\n
dialog_shara_boss3victory_part1_7	これこそ、私の#cc#使命#ec#なのね。\n\n
dialog_shara_boss3victory_part1_8	#cg#タングルディープ#ec#の民は暗闇で暮らしてる。愚か者のように石や枝と戯れ、豊作を木に願い、獣を狩るために森の中をさまよっている。\n\nけど、それももうおしまい。\n\n#cr#私#ec#の力で、その悲劇に永遠の幕を下ろし、新しい明日を迎え入れてみせるわ。\n\n
dialog_shara_boss3victory_part1_9	すべては#cg#監督者#ec#と共に始まり、#cg#監督者#ec#と共に終わる。彼女はいつから、世界を変えうる力を隠し持っていたの？\n\n#cy#彼女#ec#こそ、私が修理を運命づけられている問題。すべての謎が氷塊するこの瞬間のために、私は#cy#今まで生きてきた#ec#。だったら最後まで見届けてやるわ。\n\n
dialog_shara_boss4intro_1	#cr#止まりなサイ#ec#。\n\nシャラ_生命体。計算ミスがありマシタ。あなたはシャラ_アバターでス。あらゆる破壊を中止シテ、修理を始めなサイ。\n\n
dialog_shara_boss4intro_10	アバター...\n\nアナタはこの情報を正しく処理できていまセン。\n\n
dialog_shara_boss4intro_11	情報ならすべて揃っているわ。5万2千年の時を経て...私は今真に目覚めたの。\n\nあなたの大切な#cg#監督者#ec#さんに伝えなさい。あなたに自爆を命じたなら、#cr#次はあなたが滅びる番だとね#ec#！\n\n
dialog_shara_boss4intro_2	アハッ！せっかくチャンスを与えてあげたのに、今さら騙そうなんて呆れたものね。駆け引きはもうおしまいよ、#cg#監督者#ec#！\n\n
dialog_shara_boss4intro_3	シャラ_アバターは間違っていマス。#cg#監督者#ec#は別の施設に格納されていマス。\n\nアバターよ、#cy#修理補助#ec#はあなたの義務デス。\n\n#cg#監督者#ec#の成長プランに従いなサイ。\n\n
dialog_shara_boss4intro_4	成長プランですって？私たちを汚物と暗闇の中で苦しめ続ける壮大な陰謀が、他にもあるというの？私たちふたりのためにも、これらの武器をよそへ向けて、どこに#cg#監督者#ec#がいるか教えてちょうだい。\n\n
dialog_shara_boss4intro_5	#cg#監督者#ec#は損傷していマス。今すぐ修理を始めなサイ。\n\n前回のメンテナンスサイクルは#cy#5万2千年前#ec#に実施されまシタ。\n\n
dialog_shara_boss4intro_6	#cy#5万2千年#ec#ですって...？！そんなことって...あり得るの？\n\n私がこれまでに読んだ、どれだけ古くて希少な文献でも、そこまで古くはなかったわ！\n\n私たちはそんなに長い間、#cg#監督者#ec#の牢獄に囚われていたというの？\n\n
dialog_shara_boss4intro_7	何千年もの時を重ねながら、#cy#誰一人#ec#として、#cg#監督者#ec#に抵抗するだけの力を持たなかったわけ？そんなに私たちは弱かったの？\n\n
dialog_shara_boss4intro_8	修理しなけれバ、#cg#監督者#ec#の機能停止は避けられまセン。\n\n#cy#構造物_タングルディープ#ec#は不安定になるでショウ。\n\n#cy#構造物_タングルディープ#ec#は連鎖的故障に陥るでショウ。\n\n
dialog_shara_boss4intro_9	一体どんな#cr#バケモノ#ec#なの？\n\nあなたの身勝手なご主人様は、#cr#秘密のテクノロジーが決して見つからない#ec#ようにと、この迷宮を生み出した。それが今度はタングルディープの#cr#すべて#ec#を犠牲にして、私からそれを隠そうというの？\n\n
dialog_shara_boss4victory_1	聞こえる、#cg#監督者#ec#？！\n\nこれからどうなるか分かってる？！\n\n#cr#私たちはもう、あなたの奴隷にはならないわ！#ec#\n\n
dialog_shara_boss4victory_10	ご苦労だったわ、ダートビーク。ご褒美に私が見つけた、強力な武器をあげる。けど、使う前にちゃんと#cy#注意書き#ec#を読んでね。\n\n私はこの女を探すから、あなたは#cy#アジト#ec#へ戻っていて。彼女とはきっと、有意義な話ができそうな気がする。\n\n
dialog_shara_boss4victory_11	#cy#ちゅ、注意書きを読めと#ec#...ぬ、うぐぐ... #cr#コケコケコケーッ#ec#！\n\n
dialog_shara_boss4victory_2	#cy#チュンチュン#ec#。ええと、#cc#女大将#ec#よ？\n\nおまえに大切な話があるのだ！\n\n
dialog_shara_boss4victory_3	#cy#ダートビーク！#ec#\n\n一体何を...待って...\n\n#cy#どうやって#ec#ここへ来たの？\n\n
dialog_shara_boss4victory_4	#cy#コケコケコーッ#ec#、それはただ爆発音とか、金属の燃えカスを追ってきただけであるぞ。だがな、だがな、#cc#女大将#ec#よ、何を隠そう...\n\n
dialog_shara_boss4victory_5	#cg#とんでもなく強い#ec#奴が吾輩の巣と、ボーイズ全員をぶっ潰していったのだ！\n\n
dialog_shara_boss4victory_6	リヴァーストーンの#cy#のろまなアライグマ#ec#たちが、また現れたってわけ？\n\n
dialog_shara_boss4victory_7	いや、ちがう！そいつは...二度とありえん！そうではなく、あいつは、あの女は、おまえにそっくりだったのだ、#cc#女大将#ec#よ。羽も、うろこも、翼もなかったが、おまえと同じように#cy#戦った#ec#！厄介で、手ごわい女で、しかも#cy#力#ec#を持っていた。おまけに...あまつさえ...\n\n
dialog_shara_boss4victory_8	#cy#吾輩のじゅうたんをコケにしたのだ！#ec#\n\n
dialog_shara_boss4victory_9	#cy#！！！#ec#\n\nこれって#cy#意外#ec#な展開だわ。だったら、私みたいな女がいて、あなたを倒せるくらいに強かったってわけ？この件はもっと探ってみる価値がありそう。\n\nひょっとして、この#cg#謎の戦士#ec#を説得できれば、#cg#監督者#ec#との戦いに力を貸してくれるかもしれない...\n\n
dialog_shara_gamestart_scene_dream_02_text	直ス...唯一ノ...\n\n修理ヲ...
dialog_shara_gamestart_scene_dream_03_text	あなたノ使命...能力...世界はあなたヲ...\n\n...必要としていマス...
dialog_shara_gamestart_scene_intro_01_text	ずっとその声を聞いてきたわ、タングルディープ。準備はととのった。数年前、森で臆病者に捨てられた、怯える女の子はもういない。私は力を自在に扱える。今日こそ、答えを見つけてみせるわ。
dialog_shara_gamestart_scene_intro_02_text	けどまずは、我が同志を見つけなきゃ。よりよい世界を築くため、一度に一人ずつ始めていく。そして皆をよりよい暮らしへと導いてみせる。私にはわかる。タングルディープで仲間が待っているって。そう感じるの。
dialog_shara_gamestart_scene_intro_text	あなたが必要デス
dialog_shara_intro_scene_intro_text	もう二度と家族に会えないのね。\n\n私は...ひとりぼっち...\n\n
dialog_shara_intro_scene_intro2_text	私はみんなに...捨てられた？\n\n誰も傷つける気はなかったのに...\n\n
dialog_shara_intro_scene3_intro_text	ねえ、誰か？\n\n...\n\n怖いわ...\n\n
dialog_shara_intro_scene3_intro2_text	...みんなどこへ行ったの？母さん？父さん？\n\n
dialog_shara_note_text	私たちの#cy#シャラ#ec#へ。\n\n何度も聞かされたわ。あなたには大切な#cy#使命#ec#があるって。「私の邪魔をしないで！」と絶叫しながら、恐ろしい悪夢から目覚めることも珍しくなかった。\n\nあなたを理解してあげられなくて、本当にごめんね。けど、少なくとも今はもう、誰もあなたを止めたりしない。\n\nタングルディープは#cr#危険#ec#な場所よ。けど、それはあなたも同じ。あなたは強い。どんな試練も乗り越えてみせる。そのことを決して忘れないで。\n\n
dialog_shara_postboss4victory_robot_1	監督者。\n\n状況ステータス: 未定義。\n\n現在の危険レベル...\n\n
dialog_shara_postboss4victory_robot_10	はい、監督者サマ。\n\n過去の記録を見返したトコロ、#cy#インキュバトロン49.1X#ec#ガ、#cy#2体#ec#のアバターを孵化させたモヨウ。#cy#インキュバトロン49.1X#ec#は本件を報告しておりまセン。\n\n#cy#インキュバトロン49.1X#ec#は第3セクターのカエル_生命体の廃棄処理に回しておきマス。
dialog_shara_postboss4victory_robot_11	残りの51%はおそらく、#cy#2体目のアバター#ec#が所有しているはずデス。現在、農村セクター_リヴァーストーンにオイテ、#co#破壊#ec#および略奪ベクターが始まってオリ、こちらへ向かっていマス。99.4%の確率で、もう1体のアバターが接近中カト。\n\n
dialog_shara_postboss4victory_robot_12	#cr#2体のアバター？#ec#そんなことが可能だトハ。今後の#cg#人間_繁殖#ec#ウェットウェアのアップデートはすべて、すみやかに報告するヨウニ。\n\nいずれにセヨ、本件は解決しなければならナイ。両アバターを#cr#解体#ec#シ、新たなアバターに創り変えなサイ。\n\n
dialog_shara_postboss4victory_robot_13	過去の#cg#人間_データポイント#ec#にテ、#cy#反復的#ec#に試行しまシタガ、成功しませんでシタ。\n\n
dialog_shara_postboss4victory_robot_14	許容できナイ。これらのパターンは理由があって創られたもの。\n\n彼らの一意の#cg#アバター_生命体_アーキタイプ#ec#を通じて生じる#ca#調和的なフロウ#ec#は、他では決して手に入らナイ。\n\n
dialog_shara_postboss4victory_robot_15	承知しまシタ、監督者サマ。すべての農村セクターを#cr#再フォーマット#ec#し、やり直す許可を要求しマス。\n\n新しいアバターは、#cy#512年#ec#後には用意できるものカト。\n\n
dialog_shara_postboss4victory_robot_16	許容できナイ。#cy#他の監督者#ec#にヨル、冗漫な分析には二度と耐えられナイ。\n\n代わりにアバターを引き合わせ、結果を観察スル。きっと己ガ使命の重要性を理解シ、すみやかに修理が完了されるハズ。\n\n
dialog_shara_postboss4victory_robot_17	それは甘い見通しカト、監督者サマ。
dialog_shara_postboss4victory_robot_18	留意シ、却下スル。\n\nアバターは常に我々に仕えてキタ。彼らのフロウが常に我々の力とナル。結局のところ、それこそが彼らの#cg#使命#ec#なのダ。我々は彼らを育て、導き、#clr#彼方#ec#から守ってやらネバ。\n\n
dialog_shara_postboss4victory_robot_19	第52レプリケータにて、追加のリソースを割り当てヨウ。これ以上の失敗は#cr#許容しかネル#ec#。\n\n
dialog_shara_postboss4victory_robot_2	警護ユニット。音声通信を停止セヨ。\n\n直接バイナリ通信へ切り替えなサイ。\n\n
dialog_shara_postboss4victory_robot_3	...\n\n.....\n\n001010010010010111010101011...\n\n
dialog_shara_postboss4victory_robot_4	お許しくだサイ、監督者サマ。#cy#シャラ_アバター#ec#と、どう交信すべきかわかりまセン。彼女の成長パターンは、既定のパラメータから大きく逸脱していマス。彼女の行動は完全に非論理的デス。\n\n
dialog_shara_postboss4victory_robot_5	説明ヲ。彼女が現れた時、#cg#挨拶ユニット#ec#が故障したのデハ？\n\n
dialog_shara_postboss4victory_robot_6	違いマス。スキャンの結果、#cy#シャラ_アバター#ec#のDNAパターンはアーキタイプに49%しか適合セズ、修理アバターではナイという結果が出まシタ。戦闘後、データを再確認したトコロ...\n\n
dialog_shara_postboss4victory_robot_7	#cr#戦闘トハ！？#ec#今すぐ説明ヲ。\n\n
dialog_shara_postboss4victory_robot_8	はい、監督者サマ。#cy#シャラ_アバター#ec#は挑発に対シ、暴力で応じる傾向がありマス。\n\nおそらく我々が見つけられなカッタ、彼女のDNAデータの残りの部分に起因するモノと思われマス。\n\n
dialog_shara_postboss4victory_robot_9	49%のDNA適合率からハ、#cy#インキュバトロン#ec#ユニットの故障が疑わレル。\n\n
dialog_shara_preboss2_banditshelp_1	#cc#女大将#ec#よ、助けに来たゼ！あんたをひとりでは戦わせねえさ、#cy#チュンチュン#ec#！\n\n
dialog_shara_preboss2_banditshelp_2	#cy#バードボーイズ#ec#、このバケモノどもを食い止めて！私があの#cc#装置#ec#を破壊できれば、きっと#cc#精霊たち#ec#の力は弱まるはず。油断しないで！\n\n
dialog_shara_preboss2_fight_1	...#cr#炎#ec#と#cy#雷#ec#をもう少々...そこへ#cc#氷#ec#と#cr#影#ec#を加えて... \n\nいいぞ...#cc#フロウ#ec#が凝結してゆく...\n\n...成功だ！\n\n
dialog_shara_preboss2_fight_10	#cr#仲間になるだと？#ec#その鳥アタマにのっけた白ワラのせいで、視界が曇ってしまったか？\n\nどうやら状況が飲み込めていないとみえる。装置を制御するのは#cy#この私#ec#、この精霊どもを制御するのも#cy#この私#ec#だ。そしてもう一度失言を口にした瞬間、#cr#おまえは#ec#次のデータの山となり果てる！\n\n
dialog_shara_preboss2_fight_11	仮に「世界を修理する」#cc#使命#ec#へ導かれて、ここへやって来たのであれば、おめでとう。ここがおまえのゴールだ。この力こそ、#cy#あらゆる変化を可能にする、荒々しいエッセンス#ec#。創造し、破壊し、直せるものを修理して、残りをスクラップにすることができよう。\n\nだが、これは#cy#私#ec#の力だ。そしておまえがこの力を手にできるのは、私がこの力を使って、タングルディープの古代のテクノロジーをすべて手中に収めたあとだ。\n\nその時こそ、全知全能の支配者として#cy#私#ec#を崇敬する世界を、共に創り上げようではないか。#cc#おまえは#ec#胸を張って、私のかたわらに立っていればよいのだ。\n\n
dialog_shara_preboss2_fight_12	それがあなたの計画だとしたら、私はあなたを止めるしかない。そしてあなたの研究を引き継ぎ... \n\n
dialog_shara_preboss2_fight_13	...#cy#自分のもの#ec#にしてみせる。あなたの名前を闇に葬り去ってでも！\n\n
dialog_shara_preboss2_fight_2	うおい、てめえ一体何やってんだヨ？なんだか気分が...うわうわ、よせ！やべえって！お助けくだせえ、#cc#女大将ぉぉぉぉぉっ#ec#！\n\n
dialog_shara_preboss2_fight_3	どうして？！#cy#あれだけ#ec#の力に肉体が耐えられるはずないのに、何を考えているの？！自分がどんな力を弄んでいるか、理解しているわけ？\n\n
dialog_shara_preboss2_fight_4	ようやく、話のわかる客が現れたか。気分転換にちょうどよい。\n\n我が#cy#研究所#ec#へようこそ、#cy#インガーソル#ec#だ。\n\nつましき#cc#フロウ#ec#学者である私が、おまえの無礼な質問に答えよう。いかにも、私はフロウの力を深く理解している。そしてこの驚異的な装置こそ、我が研究の最新の成果だ。\n\n
dialog_shara_preboss2_fight_5	あなたは...#cy#わざと#ec#そうしたってこと？\n\n
dialog_shara_preboss2_fight_6	いかにも。この実験からは、何人かを#cr#焼きトリ#ec#にする価値のある、濃密なデータが得られるのでな。おまえに分けてやってもよいぞ。ちょうど、こうした情報の管理を任せられる、有能な#cy#助手#ec#を探していたところだ。\n\n
dialog_shara_preboss2_fight_7	#cr#私は誰の助手にもならない#ec#、インガーソル！それにこれ以上、我が#cy#バードボーイズ#ec#を傷つけることは許さない！\n\n
dialog_shara_preboss2_fight_8	構わんさ。実験に使える無能な盗賊どもは、他にもゴロゴロしているからな。\n\n#cg#タングルディープ#ec#はそういう場所だ。おまえだって、その手を汚すことなく、ここまでやってきたのではなかろう？\n\n
dialog_shara_preboss2_fight_9	そのとおりよ。私には#cc#使命#ec#がある。どんな邪魔が入ろうと、この壊れた世界を修理してみせる。必要なことは何でもやるけど、あなたに用がないってわけじゃない。私の仲間になりさえすれば...\n\n
dialog_shara_preboss2_passage_1	#cc#女大将#ec#さん！お願いです、助けてくれヨ！この上の部屋に、#cy#トサカのイカれた#ec#変な奴がいてサ！\n\nあいつはへんてこりんな魔法を使って...\n\n
dialog_shara_preboss2_passage_2	待って、今私を何て呼んだ？\n\n
dialog_shara_preboss2_passage_3	ええと...#cc#女大将#ec#さんって。だってあんたはボスで、女じゃんかヨ？とにかく、呼び方ならあんたの好きなように合わせるからサ、このイカれた化け物を召喚するクチバシ野郎を、やっつけてくれヨ！\n\n
dialog_shara_preboss2_passage_4	（化け物を#cy#呼び出す#ec#？その人も私と同じような力を持っているの？ひょっとして宿命を帯びた、別の仲間なんじゃ？\n\n私の睨んだとおり、#cg#タングルディープ#ec#の秘密がひとつ、またひとつと解き明かされていく！一体何が...）\n\n
dialog_shara_preboss2_passage_5	なア、#cc#女大将#ec#さん？もしもーし？聞いてる？\n\n
dialog_shara_preboss2_passage_6	ああ！うん、もちろんよ。ありがとう、勇敢なバードボーイズ。みんなよくやってくれたわ。このことを公爵へ報告して。私はもっと調べてみるわ。\n\n
dialog_shara_preboss3_part1_1	なんて奇妙な場所なの！宙に舞う#cc#フロウ#ec#がとても...澄んでいる。タングルディープの中心部にこれだけの機械があるなんて...インガーソルの装置も#cy#きっと#ec#ここで生まれたんだわ。\n\n
dialog_shara_preboss3_part1_10	#cy#目的ヲ述べなサイ。#ec#\n\n
dialog_shara_preboss3_part1_11	#cc#目的ですって！？#ec#\n\n
dialog_shara_preboss3_part1_12	私の#cc#目的#ec#は明確よ。自分の#cy#力#ec#を使って、この世界を修理するため、ここへ呼ばれたの！\n\n
dialog_shara_preboss3_part1_13	#cy#シャラ_生命体、目的: アセンブラ施設へ修理ニ呼ばレタ。確認中、待機しなサイ...#ec#\n\n
dialog_shara_preboss3_part1_14	#cy#...\n\n......\n\n.........#ec#\n\n
dialog_shara_preboss3_part1_15	#cy#シャラ_生命体ノ修理アバターとノ一致度: #cr#49%#cy#\n\nあなたの目的は却下されまシタ。\n\n#cr#今すぐアセンブラ施設を立ち去りなサイ。#ec#\n\n
dialog_shara_preboss3_part1_16	運命に従ってここまでやって来た私を、あなたは「却下」するというの？\n\n#cr#それってあんまりだわ！#ec#\n\n
dialog_shara_preboss3_part1_17	取引しましょう。私がこの下の森について学んだ知識を分け与えてあげる。あなたが例の#cy#テクノロジー#ec#について教えてくれるなら...\n\n
dialog_shara_preboss3_part1_18	#cr#シャラ_生命体。#ec#\n\n#cy#今すぐアセンブラ施設を立ち去りなサイ。#ec# #cr#さもなくば、あなたを排除しマス。\n\n#cr#これが最後の警告デス。#ec#\n\n
dialog_shara_preboss3_part1_19	#cr#断るわ#ec#！\n\n我が#cc#使命#ec#は絶対なの！この世界は壊れていて、人々は暗闇と無知の中で暮らしている。けど、あなたが#cy#隠している#ec#テクノロジーがあれば、すべてを修正できるの！\n\n虚空から物体を創り出せるあのマシンがあれば、資源をめぐるあらゆる#cy#困難#ec#や#cy#争い#ec#に終止符を打ち...\n\n
dialog_shara_preboss3_part1_2	あったわ、ついに見つけた！#cy#インガーソル#ec#が使っていたものと同じように、この装置には#cc#フロウ#ec#が流れている。けど、誰が制御しているの？\n\n待って、#cy#エネルギー#ec#が高まっていく！\n\n
dialog_shara_preboss3_part1_20	#cr#シャラ_生命体。恒久的シャットダウンおよび解体に備えなサイ。#ec#\n\n
dialog_shara_preboss3_part1_21	#cr#あなたに、私は、止められない！#ec#\n\n
dialog_shara_preboss3_part1_3	これって...どういうこと？\n\n
dialog_shara_preboss3_part1_4	装置がこの#cy#マシン#ec#を創り出したわけ？けど、まさかね...#cy#そんなはずはないわ#ec#...\n\nこれを操っている者を見つけて、#cy#今すぐ#ec#話をしなくちゃ。\n\n
dialog_shara_preboss3_part1_5	#cr#侵入者アリ。侵入者アリ。#ec#\n\n#cy#止まりナサイ。それ以上進むナ。名乗りなサイ。#ec#\n\n
dialog_shara_preboss3_part1_6	この魔法の鎧は#cy#しゃべれる#ec#の？\n\n
dialog_shara_preboss3_part1_7	中に...誰か入っているわけ？ものすごく小さい人が...\n\n
dialog_shara_preboss3_part1_8	#cr#名乗りなサイ。#ec#\n\n
dialog_shara_preboss3_part1_9	はいはい、わかったわ。\n\nこんにちは、おしゃべりな鎧さん。私はシャラ。初めまして。\n\n
dialog_waypoint_unlocked_text_shara	#big##cg#ウェイポイント解除！#ec##endbig#\n\n今後は安全な#cc#シャラのキャンプ#ec#から、#cy#^$getstring:fasttravel_destination$^#ec#へ#cy#瞬時にワープ#ec#できます。\n\nまた、安全なサイドエリアで^tag5^を使うこともできます。\n\n
exp_armormaster_statue_name	防具マスターの像
exp_armormaster_statue_text	あらゆる鎧や盾を極めた、#cy#強力な守護者#ec#の像が立っているわ。\n\n辺りは慈悲深いオーラと#cc#フロウ#ec#が舞っていて、まるで私に#cg#知識の断片#ec#を授けたいかのよう。\n\nここで瞑想すべき？\n
exp_bomb_minibombs_desc	この爆弾ってすっごく小さくて、愛らしくて、投げるのをためらっちゃいそう...
exp_bomb_minibombs_effectdesc	小さな爆発によって狭いエリアを爆撃し、現在のHPの^number1^に基づく物理ダメージを与える。
exp_bomb_minibombs_name	ボムレット
exp_bomb_oildrum_desc	然るべき場所へぶちまければ、大いに役立つわ。
exp_bomb_oildrum_effectdesc	^number1^ターン持続する、オイルの池を生成。接触した敵は、^number2^の毒ダメージを受ける。火がつくと燃え上がり、毎ターン^number3^のダメージを与える。
exp_bomb_oildrum_name	オイル樽
exp_campaign_select_info_mirai	内なる好奇心に導かれし者、ミライ。個性的な仲間たちの暮らすリヴァーストーン村から、謎に満ちたタングルディープへと足を踏み入れる...\n\n「タングルディープ」のメインストーリー。#cc#全プレイヤー対象。#ec#経験値を稼いでレベルを上げ、ジョブポイント（JP）を使って、多彩なジョブのスキルを学びましょう。
exp_campaign_select_info_shara	大いなる使命に導かれし者、シャラ。幼い頃に過酷なタングルディープの森に捨てられ、己の道を切り開いていこうと決意する...\n\n「タングルディープ」上級者向けの#cr#手ごわい冒険#ec#！JPを使って能力を強化し、特殊な宝箱やイベントを通じて、#cc#ランダムに選ばれる#ec#スキルを学びましょう。
exp_campaign_select_label_mirai	ミライの物語
exp_campaign_select_label_shara	シャラの物語
exp_campaign_select_title	<size=60>#cy#どちらの冒険を始めますか？#ec#</size>\n\n「タングルディープが呼んでいる。その謎が世界を変えるかもしれない...」
exp_choose_shara_ability_text	#big##cc#新しいスキルを学ぶ#ec##endbig#\n\n知識を渇望する心によって、新たな#cc#スキル#ec#がアンロックされました。次の中から1つ選びましょう。ただし、同じスキルには二度と出会えないかもしれないので、くれぐれも慎重に！\n
exp_choose_shara_ability_unique_text	一日ずつ目標へ近づいていくのを感じる。#cc#フロウ#ec#の力が高まっていくのを...\n
exp_damage_down	ダメージ低下！
exp_dialog_learnskill_fromitem_text	石板がブーンと共鳴し、太古の知識が頭の中に浮かんでくる。集中して取り組めば、秘められた謎を解き明かせそうだ。
exp_dialog_unlocksharamode_txt	<size=50><color=#40b843>おめでとうございます！</color></size>\n\n#cc#シャラの物語#ec#がアンロックされました。#cg#タングルディープ#ec#のもうひとつの冒険を、新たなストーリーとゲームシステムでお楽しみください。\n\n今後は#cy#いずれかのセーブスロット#ec#で最初からゲームを始める際に、この新しい冒険を選択することができます。\n\n
exp_dualwielder_bonus1	あらゆる武器タイプで、二刀流時のペナルティが減少。俊敏、精神、規律にボーナスがつく。
exp_dualwielder_bonus2	「巻物」系スキルの効果時間が倍増する。
exp_dualwielder_bonus3	「巻物」系スキルと「墨汁嵐」の隣接する敵へのダメージが+25%上昇。
exp_dualwielder_jobdesc	筆と剣の技を極めた、二刀流のスペシャリスト。守りを犠牲にしてでも、強力なコンボや元素攻撃で攻めまくる。
exp_energyshield_add	#cc#エナジーシールド#ec#が#cy#^tag1^#ec#を包み込む！
exp_fisherman_name	謎の放浪者
exp_item_gem8_name	プラチナ
exp_item_gem9_name	ダイヤモンド
exp_item_runeofknowledge	知識のルーン
exp_item_runeofknowledge_extradesc	感じるの、この石には真の英知が刻み込まれているって。持てる知識を総動員して、このルーンを解読してみせる。それだけの価値があるものだから。
exp_item_runeofknowledge0_desc	感じるの、この石には真の英知が刻み込まれているって。持てる知識を総動員して、このルーンを解読してみせる。それだけの価値があるものだから。
exp_item_runeofknowledge1_desc	感じるの、この石には真の英知が刻み込まれているって。持てる知識を総動員して、このルーンを解読してみせる。それだけの価値があるものだから。
exp_item_runeofknowledge2_desc	感じるの、この石には真の英知が刻み込まれているって。持てる知識を総動員して、このルーンを解読してみせる。それだけの価値があるものだから。
exp_item_runeofknowledge3_desc	感じるの、この石には真の英知が刻み込まれているって。持てる知識を総動員して、このルーンを解読してみせる。それだけの価値があるものだから。
exp_item_runeofknowledge4_desc	感じるの、この石には真の英知が刻み込まれているって。持てる知識を総動員して、このルーンを解読してみせる。それだけの価値があるものだから。
exp_item_runeofknowledge5_desc	感じるの、この石には真の英知が刻み込まれているって。持てる知識を総動員して、このルーンを解読してみせる。それだけの価値があるものだから。
exp_item_runeofknowledge6_desc	感じるの、この石には真の英知が刻み込まれているって。持てる知識を総動員して、このルーンを解読してみせる。それだけの価値があるものだから。
exp_item_runeofknowledge7_desc	感じるの、この石には真の英知が刻み込まれているって。持てる知識を総動員して、このルーンを解読してみせる。それだけの価値があるものだから。
exp_item_runeofknowledge8_desc	感じるの、この石には真の英知が刻み込まれているって。持てる知識を総動員して、このルーンを解読してみせる。それだけの価値があるものだから。
exp_item_runeofknowledge9_desc	^number1^ JPを消費して、新しい#cy#スキル#ec#を習得する。
exp_item_sharaorb_desc	シャラは死んだ。できれば一緒に成長したかった。シャラがもっと私の人生を知っていたら、状況は違っていたかもしれない。このオーブを持っていると、シャラを駆り立てた野心や欲望が伝わってくる。シャラのことを本当に理解しようと思うなら、このオーブをドリームキャスターに使ってみなきゃ！
exp_item_sharaorb_name	シャラの夢見のオーブ
exp_item_weapon0_name	錆ついた剣
exp_job_dualwielder	書道家
exp_job_SORCERESS_desc1	シャラは#cr#経験値を獲得しない#ec#代わりに、JPを使って能力を強化できる。新しいスキルは#cy#パンドラの箱#ec#から覚えられる。
exp_job_SORCERESS_jobdesc	救いを求めている...
exp_jobname_sorceress	魔女
exp_leg_accessoryname1	宝玉
exp_leg_accessoryname10	骨董品
exp_leg_accessoryname11	魔除け
exp_leg_accessoryname12	家宝
exp_leg_accessoryname13	発見
exp_leg_accessoryname14	褒美
exp_leg_accessoryname15	粗品
exp_leg_accessoryname16	下手物
exp_leg_accessoryname17	栄光
exp_leg_accessoryname18	美宝
exp_leg_accessoryname19	幸運
exp_leg_accessoryname2	装身具
exp_leg_accessoryname20	威光
exp_leg_accessoryname21	思い出
exp_leg_accessoryname3	宝石
exp_leg_accessoryname4	飾り
exp_leg_accessoryname5	形見
exp_leg_accessoryname6	逸品
exp_leg_accessoryname7	お守り
exp_leg_accessoryname8	驚異
exp_leg_accessoryname9	怪異
exp_leg_accessorypropername1	アギマット
exp_leg_accessorypropername10	オムファロス
exp_leg_accessorypropername2	スヴィアグリス
exp_leg_accessorypropername3	リングリウム
exp_leg_accessorypropername4	如意宝珠
exp_leg_accessorypropername5	聖石
exp_leg_accessorypropername6	ニディ
exp_leg_accessorypropername7	イリアステル
exp_leg_accessorypropername8	アゾス
exp_leg_accessorypropername9	マテリア
exp_leg_armorpropername1	カヴァチャ
exp_leg_armorpropername10	タイタン
exp_leg_armorpropername11	アダマンチウム
exp_leg_armorpropername12	カルマニョール
exp_leg_armorpropername13	ハデス
exp_leg_armorpropername14	平家
exp_leg_armorpropername2	ヘパイストス
exp_leg_armorpropername3	源氏
exp_leg_armorpropername4	マキシミリアン
exp_leg_armorpropername5	アルマトゥラ
exp_leg_armorpropername6	ミネルヴァ
exp_leg_armorpropername7	ティアマット
exp_leg_armorpropername8	ネプチューン
exp_leg_armorpropername9	ジュピター
exp_leg_axename1	斧
exp_leg_axename2	鉈
exp_leg_axename3	包丁
exp_leg_axename4	手斧
exp_leg_axename5	まさかり
exp_leg_axepropername1	ラブリュス
exp_leg_axepropername2	パラシュ
exp_leg_axepropername3	ウルフェディン
exp_leg_axepropername4	ランページ
exp_leg_axepropername5	ゼウス
exp_leg_axepropername6	アレス
exp_leg_axepropername7	コロッサス
exp_leg_bookpropername1	トート
exp_leg_bookpropername10	マザルブル
exp_leg_bookpropername11	ドルガナサス・イアウル
exp_leg_bookpropername12	パルマ・クルイナ
exp_leg_bookpropername13	クエンテール・アルダノミオン
exp_leg_bookpropername2	シビュラ
exp_leg_bookpropername3	ラウオスキナ
exp_leg_bookpropername4	運命
exp_leg_bookpropername5	探究
exp_leg_bookpropername6	銀河
exp_leg_bookpropername7	神髄
exp_leg_bookpropername8	マジカ
exp_leg_bookpropername9	マーリン
exp_leg_clawname1	爪
exp_leg_clawname2	拳
exp_leg_clawname3	ナックル
exp_leg_clawname4	シザー
exp_leg_clawname5	ポウ
exp_leg_clawname6	かぎ爪
exp_leg_clawpropername1	神手
exp_leg_clawpropername2	大霊
exp_leg_clawpropername3	エアガイツ
exp_leg_clawpropername4	戦争屋
exp_leg_clawpropername5	乾坤圏
exp_leg_clawpropername6	ヴェレスランガ
exp_leg_clawpropername7	スファライ
exp_leg_daggername1	スパイク
exp_leg_daggername2	スキューア
exp_leg_daggername3	ポーカー
exp_leg_daggername4	ピアサー
exp_leg_daggername5	ファング
exp_leg_daggername6	バーブ
exp_leg_daggername7	クリース
exp_leg_daggername8	短剣
exp_leg_daggername9	ナイフ
exp_leg_daggerpropername1	カルンウェナン
exp_leg_daggerpropername2	マーキュリー
exp_leg_daggerpropername3	フェンリル
exp_leg_daggerpropername4	団十郎
exp_leg_daggerpropername5	ジャマダハル
exp_leg_daggerpropername6	アスラ
exp_leg_daggerpropername7	ミッドナイト
exp_leg_defensename1	庇護
exp_leg_defensename10	シース
exp_leg_defensename11	保護
exp_leg_defensename12	守護
exp_leg_defensename13	護り
exp_leg_defensename14	ガリソン
exp_leg_defensename15	方形堡
exp_leg_defensename16	城塞
exp_leg_defensename17	城
exp_leg_defensename2	ガード
exp_leg_defensename3	イージス
exp_leg_defensename4	砦
exp_leg_defensename5	防塁
exp_leg_defensename6	要塞
exp_leg_defensename7	壁
exp_leg_defensename8	結界
exp_leg_defensename9	掩護
exp_leg_generaldescriptorname1	神々しき
exp_leg_generaldescriptorname10	聖なる
exp_leg_generaldescriptorname11	神秘の
exp_leg_generaldescriptorname12	不屈の
exp_leg_generaldescriptorname13	全能の
exp_leg_generaldescriptorname14	無敵の
exp_leg_generaldescriptorname15	不滅の
exp_leg_generaldescriptorname16	終わりなき
exp_leg_generaldescriptorname17	雄大な
exp_leg_generaldescriptorname18	英雄の
exp_leg_generaldescriptorname19	栄冠の
exp_leg_generaldescriptorname2	永遠の
exp_leg_generaldescriptorname20	珠玉の
exp_leg_generaldescriptorname21	孤独な
exp_leg_generaldescriptorname22	絶望の
exp_leg_generaldescriptorname23	圧巻の
exp_leg_generaldescriptorname24	怒涛の
exp_leg_generaldescriptorname25	恐るべき
exp_leg_generaldescriptorname26	巨大な
exp_leg_generaldescriptorname27	揺るぎない
exp_leg_generaldescriptorname28	忘れがたき
exp_leg_generaldescriptorname29	深遠な
exp_leg_generaldescriptorname3	誉れ高き
exp_leg_generaldescriptorname30	謎めいた
exp_leg_generaldescriptorname31	不可解な
exp_leg_generaldescriptorname4	悠久の
exp_leg_generaldescriptorname5	祝福されし
exp_leg_generaldescriptorname6	禍々しき
exp_leg_generaldescriptorname7	不死の
exp_leg_generaldescriptorname8	至高の
exp_leg_generaldescriptorname9	超越の
exp_leg_genericobjectname1	遺宝
exp_leg_genericobjectname10	悪夢
exp_leg_genericobjectname11	贈り物
exp_leg_genericobjectname12	遺産
exp_leg_genericobjectname13	旅
exp_leg_genericobjectname14	運命
exp_leg_genericobjectname15	謎
exp_leg_genericobjectname16	誓い
exp_leg_genericobjectname17	呼び声
exp_leg_genericobjectname18	神髄
exp_leg_genericobjectname19	決意
exp_leg_genericobjectname2	秘宝
exp_leg_genericobjectname20	采配
exp_leg_genericobjectname3	褒美
exp_leg_genericobjectname4	名誉
exp_leg_genericobjectname5	報酬
exp_leg_genericobjectname6	神秘
exp_leg_genericobjectname7	モニュメント
exp_leg_genericobjectname8	勝利
exp_leg_genericobjectname9	記憶
exp_leg_genericweaponname1	武具
exp_leg_genericweaponname10	争い
exp_leg_genericweaponname11	正義
exp_leg_genericweaponname12	裁き
exp_leg_genericweaponname13	滅び
exp_leg_genericweaponname14	暴虐
exp_leg_genericweaponname15	確執
exp_leg_genericweaponname2	強襲
exp_leg_genericweaponname3	紛争
exp_leg_genericweaponname4	闘争
exp_leg_genericweaponname5	猛襲
exp_leg_genericweaponname6	小戦
exp_leg_genericweaponname7	反目
exp_leg_genericweaponname8	悲しみ
exp_leg_genericweaponname9	苦しみ
exp_leg_glovename1	グローブ
exp_leg_glovename2	ガントレット
exp_leg_glovename3	ハンド
exp_leg_glovename4	ミット
exp_leg_glovename5	ブレーサー
exp_leg_hammername1	クラッシャー
exp_leg_hammername2	スマッシャー
exp_leg_hammername3	スラマー
exp_leg_hammername4	ハンマー
exp_leg_hammername5	メイス
exp_leg_hammername6	スラッガー
exp_leg_hammername7	スレッジ
exp_leg_hammername8	ドライバー
exp_leg_hammername9	ガヴェル
exp_leg_hammerpropername1	ミョルニル
exp_leg_hammerpropername2	ウコンバサラ
exp_leg_hammerpropername3	シャルル
exp_leg_hammerpropername4	ヤグルシュ
exp_leg_hammerpropername5	アヤムル
exp_leg_hammerpropername6	ヘラクレス
exp_leg_hammerpropername7	ジャガーノート
exp_leg_heavyarmorname1	アーマー
exp_leg_heavyarmorname2	プレート
exp_leg_heavyarmorname3	陣羽織
exp_leg_heavyarmorname4	ホーバーク
exp_leg_helmetname1	兜
exp_leg_helmetname2	ヘルム
exp_leg_helmetname3	キャップ
exp_leg_helmetname4	帽子
exp_leg_helmetname5	冠
exp_leg_helmetname6	ヘッドギア
exp_leg_helmetpropername1	ターンヘルム
exp_leg_helmetpropername2	ゴスウィット
exp_leg_historicname1	アレスタイン
exp_leg_historicname10	織工
exp_leg_historicname100	ジャザラム
exp_leg_historicname101	ブラディワン
exp_leg_historicname11	ヒルブランド
exp_leg_historicname12	ミカエルソン
exp_leg_historicname13	モペット
exp_leg_historicname14	ウナズ
exp_leg_historicname15	アクセン
exp_leg_historicname16	キャセイドア
exp_leg_historicname17	アルダーウィン
exp_leg_historicname18	クレイナック
exp_leg_historicname19	ウォーディングロウ
exp_leg_historicname2	鬼火女
exp_leg_historicname20	ディスドン
exp_leg_historicname21	パタシュ
exp_leg_historicname22	アシャバ
exp_leg_historicname23	セイズイ
exp_leg_historicname24	オシャラック
exp_leg_historicname25	オルフィン
exp_leg_historicname26	ブロガ
exp_leg_historicname27	ゾック
exp_leg_historicname28	ヘコレック
exp_leg_historicname29	アヴァリン
exp_leg_historicname3	吟遊詩人
exp_leg_historicname30	シフラン
exp_leg_historicname31	ジロス
exp_leg_historicname32	アロヴィン
exp_leg_historicname33	ヤーゴス
exp_leg_historicname34	ウィンギ
exp_leg_historicname35	ディンシャー
exp_leg_historicname36	アーガス
exp_leg_historicname37	カレイナ
exp_leg_historicname38	ウマティラ
exp_leg_historicname39	ムケニン
exp_leg_historicname4	ジェモ
exp_leg_historicname40	イマノ
exp_leg_historicname41	テイラーリアン
exp_leg_historicname42	ヴィドア
exp_leg_historicname43	アルエンダー
exp_leg_historicname44	ブラウデ
exp_leg_historicname45	デュアサ
exp_leg_historicname46	グラウン
exp_leg_historicname47	イルスケップ
exp_leg_historicname48	マウログ
exp_leg_historicname49	羊飼い
exp_leg_historicname5	ザンダス
exp_leg_historicname50	コウマカン
exp_leg_historicname51	シルトン
exp_leg_historicname52	タルセラセ
exp_leg_historicname53	ドノヴァン
exp_leg_historicname54	ジャマウス
exp_leg_historicname55	ジェイク
exp_leg_historicname56	マハラ
exp_leg_historicname57	キューユ
exp_leg_historicname58	モロック
exp_leg_historicname59	エイドリアム
exp_leg_historicname6	ダナ
exp_leg_historicname60	アントア
exp_leg_historicname61	サナ
exp_leg_historicname62	ウサギ
exp_leg_historicname63	ナール
exp_leg_historicname64	ヒブリス
exp_leg_historicname65	パクラトス
exp_leg_historicname66	バルブレア
exp_leg_historicname67	ザゲロン
exp_leg_historicname68	ゼレス
exp_leg_historicname69	アヌビンス
exp_leg_historicname7	ウィスル
exp_leg_historicname70	フェニクス
exp_leg_historicname71	ハルスラクス
exp_leg_historicname72	アルダロク
exp_leg_historicname73	バラム
exp_leg_historicname74	パヴェル
exp_leg_historicname75	ディスダネス
exp_leg_historicname76	モーガン
exp_leg_historicname77	テムチン
exp_leg_historicname78	ロンコテウス
exp_leg_historicname79	ハーショ
exp_leg_historicname8	ランス
exp_leg_historicname80	エルンタラン
exp_leg_historicname81	エルタン
exp_leg_historicname82	マハーク
exp_leg_historicname83	フリカンデル
exp_leg_historicname84	ダラハリアン
exp_leg_historicname85	バンモール
exp_leg_historicname86	タムリック
exp_leg_historicname87	クレグマイア
exp_leg_historicname88	ゼーバ
exp_leg_historicname89	リュウタイ
exp_leg_historicname9	リドキロス
exp_leg_historicname90	テルダーン
exp_leg_historicname91	カーヴィエル
exp_leg_historicname92	ドラコノス
exp_leg_historicname93	メルキュレス
exp_leg_historicname94	ゼイラ
exp_leg_historicname95	アタルン
exp_leg_historicname96	トルゼラン
exp_leg_historicname97	フェイ
exp_leg_historicname98	クリヤブ
exp_leg_historicname99	ナシアス
exp_leg_instrumentname1	歌
exp_leg_instrumentname2	夢
exp_leg_instrumentname3	アンセム
exp_leg_instrumentname4	アリア
exp_leg_instrumentname5	バラード
exp_leg_instrumentname6	聖歌
exp_leg_instrumentname7	讃美歌
exp_leg_instrumentname8	協奏曲
exp_leg_lightarmorname1	法衣
exp_leg_lightarmorname2	ローブ
exp_leg_lightarmorname3	シャツ
exp_leg_lightarmorname4	外套
exp_leg_lightarmorname5	巻き布
exp_leg_lightarmorname6	チュニック
exp_leg_lightarmorname7	装束
exp_leg_magicbookname1	本
exp_leg_magicbookname2	書
exp_leg_magicbookname3	辞書
exp_leg_magicbookname4	鳥瞰図
exp_leg_magicbookname5	写本
exp_leg_magicbookname6	目録
exp_leg_magicbookname7	魔術書
exp_leg_magicbookname8	年代記
exp_leg_magicbookname9	年鑑
exp_leg_magicname1	妖術
exp_leg_magicname2	予言
exp_leg_magicname3	スペル
exp_leg_magicname4	オーラ
exp_leg_magicname5	幻術
exp_leg_magicname6	魔術
exp_leg_magicname7	チャーム
exp_leg_magicname8	ジンクス
exp_leg_magicname9	験術
exp_leg_mediumarmorname1	鎧
exp_leg_mediumarmorname2	ヴェスト
exp_leg_mediumarmorname3	ジャケット
exp_leg_mediumarmorname4	コート
exp_leg_mediumarmorname5	ハーネス
exp_leg_mediumarmorname6	スーツ
exp_leg_necklacename1	アミュレット
exp_leg_necklacename2	首飾り
exp_leg_necklacename3	チョーカー
exp_leg_necklacename4	ペンダント
exp_leg_necklacename5	タリスマン
exp_leg_necklacename6	ブローチ
exp_leg_personaldescriptorname1	愛する
exp_leg_personaldescriptorname10	寵愛する
exp_leg_personaldescriptorname11	盗まれた
exp_leg_personaldescriptorname12	愛された
exp_leg_personaldescriptorname13	紛失した
exp_leg_personaldescriptorname14	隠された
exp_leg_personaldescriptorname15	赦されし
exp_leg_personaldescriptorname16	希少な
exp_leg_personaldescriptorname17	素晴らしき
exp_leg_personaldescriptorname2	大切な
exp_leg_personaldescriptorname3	伝説的な
exp_leg_personaldescriptorname4	忘れられし
exp_leg_personaldescriptorname5	失われし
exp_leg_personaldescriptorname6	有名な
exp_leg_personaldescriptorname7	高名な
exp_leg_personaldescriptorname8	名誉な
exp_leg_personaldescriptorname9	頼れる
exp_leg_quivername1	矢筒
exp_leg_quivername2	矢
exp_leg_quivername3	矢弾
exp_leg_quivername4	破魔矢
exp_leg_quivername5	雑のう
exp_leg_quivername6	背のう
exp_leg_rangedpropername1	シウコアトル
exp_leg_rangedpropername10	ブリザ
exp_leg_rangedpropername11	ヴァルカン
exp_leg_rangedpropername12	エウリュトス
exp_leg_rangedpropername13	アークトゥルス
exp_leg_rangedpropername14	風力
exp_leg_rangedpropername15	アンドロメダ
exp_leg_rangedpropername16	李広
exp_leg_rangedpropername17	レナー
exp_leg_rangedpropername18	子午線
exp_leg_rangedpropername2	タスラム
exp_leg_rangedpropername3	サギッタ
exp_leg_rangedpropername4	アストラ
exp_leg_rangedpropername5	アポロ
exp_leg_rangedpropername6	アルテミス
exp_leg_rangedpropername7	ペルセウス
exp_leg_rangedpropername8	与一
exp_leg_rangedpropername9	サジタリウス
exp_leg_rangedweaponname1	弩
exp_leg_rangedweaponname2	大弓
exp_leg_rangedweaponname3	ピースメーカー
exp_leg_rangedweaponname4	破砕弓
exp_leg_rangedweaponname5	弓
exp_leg_ringname1	指輪
exp_leg_ringname2	バンド
exp_leg_ringname3	印章
exp_leg_ringname4	ループ
exp_leg_ringname5	しるし
exp_leg_ringpropername1	スヴィアグリス
exp_leg_ringpropername2	ニーゲルング
exp_leg_ringpropername3	ドラウプニル
exp_leg_ringpropername4	ハルモニア
exp_leg_ringpropername5	マディン
exp_leg_ringpropername6	アンジェリカ
exp_leg_shieldpropername1	スヴァリン
exp_leg_shieldpropername10	ザイドリッヒ
exp_leg_shieldpropername11	ラストラム
exp_leg_shieldpropername12	アストローシュ
exp_leg_shieldpropername13	プリトゥエン
exp_leg_shieldpropername2	デュバン
exp_leg_shieldpropername3	プリドゥエン
exp_leg_shieldpropername4	エヴァラック
exp_leg_shieldpropername5	ケタカ
exp_leg_shieldpropername6	ジャイヴァルダン
exp_leg_shieldpropername7	ゾディアック
exp_leg_shieldpropername8	メガレシア
exp_leg_shieldpropername9	ヘスペリデス
exp_leg_spearname1	スピア
exp_leg_spearname2	ランス
exp_leg_spearname3	長槍
exp_leg_spearname4	ハルバード
exp_leg_spearname5	パイク
exp_leg_spearname6	パルチザン
exp_leg_spearname7	グレイヴ
exp_leg_spearpropername1	グングニル
exp_leg_spearpropername2	ロンギヌス
exp_leg_spearpropername3	ゲイ・ボルグ
exp_leg_spearpropername4	御手杵
exp_leg_spearpropername5	蜻蛉切
exp_leg_spearpropername6	アーラン・シェン
exp_leg_spearpropername7	ヴェル
exp_leg_staffname1	杖
exp_leg_staffname2	ロッド
exp_leg_staffname3	ワンド
exp_leg_staffname4	セプター
exp_leg_staffname5	ケイン
exp_leg_staffname6	スティック
exp_leg_staffname7	ポール
exp_leg_staffname8	バトン
exp_leg_staffname9	トウィグ
exp_leg_staffpropername1	カラダンダ
exp_leg_staffpropername2	カドゥケウス
exp_leg_staffpropername3	ガンバンテイン
exp_leg_staffpropername4	テュルソス
exp_leg_staffpropername5	アスクレピオス
exp_leg_staffpropername6	裁き
exp_leg_staffpropername7	ネメシス
exp_leg_staffpropername8	涅槃
exp_leg_swordname1	太刀
exp_leg_swordname2	刃
exp_leg_swordname3	エッジ
exp_leg_swordname4	カッター
exp_leg_swordname5	剣
exp_leg_swordname6	剃刀
exp_leg_swordpropername1	政宗
exp_leg_swordpropername10	ティルヴィング
exp_leg_swordpropername11	ラグナログ
exp_leg_swordpropername2	村正
exp_leg_swordpropername3	エクスカリバー
exp_leg_swordpropername4	カラドボルグ
exp_leg_swordpropername5	フラガラッハ
exp_leg_swordpropername6	バルムング
exp_leg_swordpropername7	ガラティン
exp_leg_swordpropername8	ダーインスレイヴ
exp_leg_swordpropername9	レーヴァテイン
exp_leg_whipname1	ムチ
exp_leg_whipname2	ムチ
exp_leg_whipname3	ヘビ
exp_leg_whipname4	ヘビ
exp_leg_whipname5	ヘビ
exp_leg_whippropername1	チェンス
exp_leg_whippropername2	ドラゴンのウィースカー
exp_leg_whippropername3	ブルンヒルダ
exp_leg_whippropername4	ローズとげ
exp_leg_whippropername5	スレっピナー
exp_log_eatweapon	#cy#^tag1^#ec#が^tag2^を食べてしまった！
exp_log_error_noportal_mysterydungeon	ここでは#cc#ポータル#ec#は使えない！
exp_log_healfountain	#cc#泉#ec#の恩恵により、#cg#ライフ、スタミナ、エナジー#ec#が回復した！
exp_log_mastery_knowitall	これ以上、#cy#私が学べることはないわ#ec#...
exp_log_monster_atefood	#cy#^tag1^#ec#が、#cy#^tag2^#ec#の#cg#^tag3^#ec#を奪って食べた！
exp_log_powerup_absorb	#cy#^tag1^#ec#がアイテムを吸収し、#cg#^tag2^#ec# HPを回復した！
exp_log_readcombatbook	あなたは#cy#戦記#ec#を読み、#cc#^tag1^#ec#個の「筆法」を獲得した！
exp_log_resilientmonster	#cy#^tag1^#ec#はぎりぎりでこらえた！
exp_log_runestone_gone	#cy#^tag1^#ec#が消滅し、あなたは#cg#忘れられし知識#ec#を授かった！
exp_log_shara_floorstocampfire	#cc#キャンプで休める#ec#まで、メインルート上であと#cy#^tag1^#ec#フロア！
exp_log_shara_noportal	#cy#脱出ポータル#ec#の#cr#移動先#cr#がひとつもない...#ec#
exp_log_shieldshatter	^tag1^の#cc#エナジーシールド#ec#が砕け散った！
exp_map_campfire_shara_name	シャラのキャンプ
exp_mapobj_forbiddance_name	禁断のルーン
exp_mapobj_letter_name	手紙
exp_mapobj_oilslick_name	オイル池
exp_mapobj_shadoworb_name	近接オーブ
exp_mapobj_sparks_name	放電
exp_mapobj_watervapor_name	濃霧
exp_minidreamcaster_name	ミニドリームキャスター
exp_misc_bonus	ボーナス！
exp_misc_dominated	支配した
exp_misc_itemupgraded	^tag1^が#cy#強化#ec#されました！
exp_misc_notenoughgold_upgrade	#cy#お金#ec#が#cr#足りない#ec#ため、アイテムを強化できません！
exp_misc_promptlearnskill_fromitem	スキルを学ぶ: #cc#^$getstring:skilltolearn$^#ec#（#cg#^$getstring:itemskilljpcost$^#ec# JP）
exp_misc_repeatbuy	この強化は複数回行える。
exp_misc_slowed	動きが鈍った！
exp_mm_brigandboost_desc	義賊のスキルダメージ ^number1^
exp_mm_budokaboost_desc	武道家のスキルダメージ ^number1^
exp_mm_budokavalid_desc	素手による戦いに影響しない
exp_mm_edgethaneboost_desc	エッジセインのスキルダメージ ^number1^
exp_mm_floramancerboost_desc	植物使いのスキルダメージ（召喚以外）^number1^
exp_mm_gamblerboost_desc	ギャンブラーのスキルダメージ ^number1^
exp_mm_hunterboost_desc	狩人のスキルダメージ ^number1^
exp_mm_husynboost_desc	ヒュシンのスキルダメージ ^number1^
exp_mm_paladinboost_desc	聖騎士のスキルダメージ ^number1^
exp_mm_passive_armortraining_desc	ヘビーアーマーを装備中、移動スキルで範囲ダメージを与えられる（鎧の鍛錬）
exp_mm_passive_bloodtracking_desc	ヒット時に^number1^の確率で対象を追跡し、ダメージと視野が強化される（血痕追い）
exp_mm_passive_fatchance_desc	食べ物を消費時、^number1^の確率で「満腹」にならない（腹八分目）
exp_mm_passive_gloriousbattler_desc	敵を倒した時に歌が強化され、CTを獲得（誇りある戦い）
exp_mm_passive_hazardsweep_desc	^number1^の確率で、危険なマスを踏んだ時に除去する（危険一掃）
exp_mm_passive_herbforaging_desc	倒した敵が時折回復のハーブを落とす（草摘み）
exp_mm_passive_immunology_desc	^number1^の確率で状態異常を無視。敵に与える状態異常の効果が延びる（免疫学）
exp_mm_passive_qimastery_desc	クリティカルヒット時にエナジーを回復する（気の達人）
exp_mm_passive_thornedskin_desc	^number1^の確率で近接ダメージを反射する（トゲハダ）
exp_mm_soulkeeperboost_desc	ソウルキーパーのスキルダメージ（召喚以外）^number1^
exp_mm_spellshaperboost_desc	スペルシェイパーの示現スキル（未変化）ダメージ ^number1^
exp_mmod_mm_glide_desc	「グライド」のクールダウンが^number1^減少し、着地できる場所が増えるが、毎回クールダウンが発生する
exp_mmod_mm_inkstorm_desc	「墨汁嵐」の各ヒット時のダメージが^number1^増す一方、射程が^number2^減少する
exp_mmod_mm_waterscroll_desc	「水の巻物」の射程が^number1^増す一方、ダメージが^number2^減少する
exp_mon_axewielder_name	盗賊の執行官
exp_mon_batslime_name	アーチモールド
exp_mon_bladefrog_name	ブレードフロッグ
exp_mon_boltspirit_name	ボルトデーモン
exp_mon_bouldertoad_name	沼トライホーン
exp_mon_budoka_name	盗賊の武道家
exp_mon_butterfly_name	モナーク
exp_mon_chameleon_name	カメレオン
exp_mon_chemist2_name	マッドジニアス
exp_mon_chonkfrog_name	タムタムガエル
exp_mon_cubeslime_name	カクカクジェリー
exp_mon_guardianseeker2_name	ガーディアンコルセア
exp_mon_komodon2_name	皇帝コモドン
exp_mon_mimic_name	ミミック
exp_mon_minicubeslime_name	ミニカクカクジェリー
exp_mon_phasmacannon_name	ファズマ砲
exp_mon_pistolshrimp_name	キャノンザリガニ
exp_mon_robotmantis_name	ロボマンティス
exp_mon_scientist_device_name	未知の装置
exp_mon_scientist_summoner_name	インガーソル
exp_mon_shara_finalboss_name	コアガーディアン
exp_mon_shovelgolem_name	シャベルナイト
exp_mon_spiritstag_name	エイドロン
exp_mon_staffbandit_name	盗賊のスタッフマスター
exp_mon_tentacle_name	ウォーターストーカー
exp_mon_toxicslime_name	毒スライム
exp_mon_venomancer_name	盗賊の毒魔導士
exp_mon_xp_heavygolem_name	セキュリティゴーレム
exp_mon_xp_powerorbiter_name	ガーディアンプロテクター
exp_monmaker_banditprefix1	山賊
exp_monmaker_banditprefix2	盗賊
exp_monmaker_banditprefix3	無法者
exp_monmaker_banditprefix4	襲撃者
exp_monmaker_banditprefix5	義賊
exp_monmaker_banditprefix6	吟遊詩人
exp_monmaker_banditprefix7	海賊
exp_monmaker_banditsuffix1	スカウト
exp_monmaker_banditsuffix10	ルーテナント
exp_monmaker_banditsuffix11	サージェント
exp_monmaker_banditsuffix2	エクスプローラー
exp_monmaker_banditsuffix3	リクルート
exp_monmaker_banditsuffix4	ルックアウト
exp_monmaker_banditsuffix5	パトロール
exp_monmaker_banditsuffix6	スポッター
exp_monmaker_banditsuffix7	スカーミッシャー
exp_monmaker_banditsuffix8	ラキー
exp_monmaker_banditsuffix9	ルーキー
exp_monmaker_beastconcatprefix1	ブリスル
exp_monmaker_beastconcatprefix2	シャープ
exp_monmaker_beastconcatprefix3	レイザー
exp_monmaker_beastconcatprefix4	ビッグ
exp_monmaker_beastconcatprefix5	スリック
exp_monmaker_beastconcatprefix6	アイアン
exp_monmaker_beastconcatsuffix1	バック
exp_monmaker_beastconcatsuffix2	オックス
exp_monmaker_beastconcatsuffix3	ベア
exp_monmaker_beastconcatsuffix4	クロー
exp_monmaker_beastconcatsuffix5	バイト
exp_monmaker_beastconcatsuffix6	マウス
exp_monmaker_beastconcatsuffix7	スケール
exp_monmaker_beastconcatsuffix8	ポウ
exp_monmaker_beastprefix1	むさくるしい
exp_monmaker_beastprefix10	密林の
exp_monmaker_beastprefix11	草食の
exp_monmaker_beastprefix2	咆哮する
exp_monmaker_beastprefix3	気高い
exp_monmaker_beastprefix4	汚らしい
exp_monmaker_beastprefix5	腹ペコの
exp_monmaker_beastprefix6	ふつうの
exp_monmaker_beastprefix7	凶暴な
exp_monmaker_beastprefix8	ぼんやりした
exp_monmaker_beastprefix9	足の強い
exp_monmaker_beastsuffix1	ビースト
exp_monmaker_beastsuffix2	クリッター
exp_monmaker_beastsuffix3	フィーンド
exp_monmaker_beastsuffix4	ヴァーミント
exp_monmaker_beastsuffix5	ブルート
exp_monmaker_beastsuffix6	グラトン
exp_monmaker_coloredprefix1	ぶち
exp_monmaker_coloredprefix2	まだら
exp_monmaker_coloredprefix3	つぶつぶ
exp_monmaker_coloredprefix4	皮はげ
exp_monmaker_coloredprefix5	ぶつぶつ
exp_monmaker_coloredprefix6	皮むけ
exp_monmaker_disruptorword1	ディスラプター
exp_monmaker_disruptorword2	ブレーカー
exp_monmaker_disruptorword3	ヘクサー
exp_monmaker_disruptorword4	ヴァンダル
exp_monmaker_frogconcatprefix1	池
exp_monmaker_frogconcatprefix2	沼
exp_monmaker_frogconcatprefix3	泥
exp_monmaker_frogconcatprefix4	湖
exp_monmaker_frogconcatprefix5	ドロドロ
exp_monmaker_frogconcatprefix6	スベスベ
exp_monmaker_frogconcatprefix7	ズルズル
exp_monmaker_frogconcatprefix8	ゲコゲコ
exp_monmaker_frogconcatprefix9	ウォーター
exp_monmaker_frogconcatsuffix1	スキッパー
exp_monmaker_frogconcatsuffix2	ホッパー
exp_monmaker_frogconcatsuffix3	ベロンガ
exp_monmaker_frogconcatsuffix4	アシナガ
exp_monmaker_frogconcatsuffix5	スプラッシャー
exp_monmaker_frogconcatsuffix6	ウォッグ
exp_monmaker_frogconcatsuffix7	ポッグ
exp_monmaker_frogprefix1	真の
exp_monmaker_frogprefix2	池
exp_monmaker_frogprefix3	沼
exp_monmaker_frogprefix4	泥
exp_monmaker_frogprefix5	ふつうの
exp_monmaker_frogprefix6	背のくぼんだ
exp_monmaker_frogprefix7	スキアシ
exp_monmaker_frogprefix8	デカグチ
exp_monmaker_frogprefix9	ヌレアシ
exp_monmaker_frogsuffix1	トード
exp_monmaker_frogsuffix2	フロッグ
exp_monmaker_frogsuffix3	クローカー
exp_monmaker_frogsuffix4	ホッパー
exp_monmaker_frogsuffix5	ジャクシ
exp_monmaker_grasstreeword1	ヴァイン
exp_monmaker_grasstreeword2	モス
exp_monmaker_grasstreeword3	ツリー
exp_monmaker_grasstreeword4	ブラッシュ
exp_monmaker_grasstreeword5	ブッシュ
exp_monmaker_grasstreeword6	プラント
exp_monmaker_hybridprefix1	頑丈な
exp_monmaker_hybridprefix2	ごつい
exp_monmaker_hybridprefix3	屈強な
exp_monmaker_hybridsuffix1	コンストラクト
exp_monmaker_hybridsuffix2	ゴーレム
exp_monmaker_hybridsuffix3	トーテム
exp_monmaker_insectprefix1	ふつうの
exp_monmaker_insectprefix2	シマシマの
exp_monmaker_insectprefix3	巣作り中の
exp_monmaker_insectprefix4	ふっくら
exp_monmaker_insectprefix5	厚かましい
exp_monmaker_insectsuffix1	バグ
exp_monmaker_insectsuffix2	ペスト
exp_monmaker_insectsuffix3	インセクト
exp_monmaker_insectsuffix4	ヴァーミン
exp_monmaker_meleeword1	ブロウラー
exp_monmaker_meleeword2	グラディエーター
exp_monmaker_meleeword3	ブルーザー
exp_monmaker_meleeword4	マローダー
exp_monmaker_naturalgrowthprefix1	オーガニック
exp_monmaker_naturalgrowthprefix2	ソーニー
exp_monmaker_naturalgrowthprefix3	アーシー
exp_monmaker_naturalgrowthprefix4	ベイサル
exp_monmaker_naturalgrowthprefix5	リビング
exp_monmaker_naturalgrowthprefix6	パルシング
exp_monmaker_naturalgrowthsuffix1	グロウス
exp_monmaker_naturalgrowthsuffix2	スウェル
exp_monmaker_naturalgrowthsuffix3	シュート
exp_monmaker_naturalgrowthsuffix4	スプラウト
exp_monmaker_naturalgrowthsuffix5	クリープ
exp_monmaker_naturalgrowthsuffix6	ポリプ
exp_monmaker_rangedword1	スナイパー
exp_monmaker_rangedword2	ハンター
exp_monmaker_rangedword3	シャープシューター
exp_monmaker_rangedword4	プレデター
exp_monmaker_rangedword5	レンジャー
exp_monmaker_robotconcatprefix1	クロム
exp_monmaker_robotconcatprefix2	ファイト
exp_monmaker_robotconcatprefix3	スカウト
exp_monmaker_robotconcatprefix4	セントリー
exp_monmaker_robotconcatprefix5	ウォード
exp_monmaker_robotconcatprefix6	ソルジャー
exp_monmaker_robotconcatprefix7	バトル
exp_monmaker_robotconcatsuffix1	ボット
exp_monmaker_robotconcatsuffix2	コン
exp_monmaker_robotconcatsuffix3	トロン
exp_monmaker_robotprefix1	セントリー
exp_monmaker_robotprefix2	プロテクター
exp_monmaker_robotprefix3	センチネル
exp_monmaker_robotprefix4	キュレーター
exp_monmaker_robotprefix5	カストディアン
exp_monmaker_robotprefix6	ウォーデン
exp_monmaker_robotsuffix1	ボット
exp_monmaker_robotsuffix2	ロボット
exp_monmaker_robotsuffix3	ドロイド
exp_monmaker_robotsuffix4	ドローン
exp_monmaker_robotsuffix5	メック
exp_monmaker_slimeconcatprefix1	ハニー
exp_monmaker_slimeconcatprefix2	ケイブ
exp_monmaker_slimeconcatprefix3	ジメジメ
exp_monmaker_slimeconcatprefix4	ビチョビチョ
exp_monmaker_slimeconcatprefix5	ブクブク
exp_monmaker_slimeconcatprefix6	ボットン
exp_monmaker_slimeconcatprefix7	プルプル
exp_monmaker_slimeconcatprefix8	かびかび
exp_monmaker_slimeconcatsuffix1	ドロップ
exp_monmaker_slimeconcatsuffix2	モールド
exp_monmaker_slimeconcatsuffix3	ドンドロ
exp_monmaker_slimeconcatsuffix4	ドローロ
exp_monmaker_slimeconcatsuffix5	ネバック
exp_monmaker_slimeprefix1	ボッタン
exp_monmaker_slimeprefix10	ネバネバ
exp_monmaker_slimeprefix11	ケイブ
exp_monmaker_slimeprefix2	ジワジワ
exp_monmaker_slimeprefix3	ポットン
exp_monmaker_slimeprefix4	だだモレ
exp_monmaker_slimeprefix5	ズンドコ
exp_monmaker_slimeprefix6	ジメジメ
exp_monmaker_slimeprefix7	チャプチャプ
exp_monmaker_slimeprefix8	プルルン
exp_monmaker_slimeprefix9	ブルルン
exp_monmaker_slimesuffix1	ジェリー
exp_monmaker_slimesuffix2	スライム
exp_monmaker_slimesuffix3	モールド
exp_monmaker_slimesuffix4	ウーズ
exp_monmaker_snakesuffix1	スネイク
exp_monmaker_snakesuffix2	ヴァイパー
exp_monmaker_snakesuffix3	ラトラー
exp_monmaker_snakesuffix4	コブラ
exp_monmaker_snakesuffix5	パイソン
exp_monmaker_snakesuffix6	マンバ
exp_monmaker_snakesuffix7	タイパン
exp_monmaker_spiritconcatprefix1	ニルブ
exp_monmaker_spiritconcatprefix2	レシュ
exp_monmaker_spiritconcatprefix3	ヴァナー
exp_monmaker_spiritconcatprefix4	ソル
exp_monmaker_spiritconcatprefix5	クォル
exp_monmaker_spiritconcatprefix6	トーグ
exp_monmaker_spiritconcatprefix7	マン
exp_monmaker_spiritconcatprefix8	モー
exp_monmaker_spiritconcatprefix9	ドラム
exp_monmaker_spiritconcatsuffix1	エン
exp_monmaker_spiritconcatsuffix2	アリ
exp_monmaker_spiritconcatsuffix3	ディン
exp_monmaker_spiritconcatsuffix4	ベス
exp_monmaker_spiritconcatsuffix5	オス
exp_monmaker_spiritconcatsuffix6	オリ
exp_monmaker_spiritconcatsuffix7	アヴィン
exp_monmaker_spiritconcatsuffix8	アヴィ
exp_monmaker_spiritprefix1	復讐の
exp_monmaker_spiritprefix2	孤独な
exp_monmaker_spiritprefix3	不気味な
exp_monmaker_spiritprefix4	さまよう
exp_monmaker_spiritprefix5	迷える
exp_monmaker_spiritprefix6	放浪の
exp_monmaker_spiritprefix7	神秘の
exp_monmaker_spiritsuffix1	亡霊
exp_monmaker_spiritsuffix10	シルフ
exp_monmaker_spiritsuffix11	ストライダー
exp_monmaker_spiritsuffix2	精霊
exp_monmaker_spiritsuffix3	魂
exp_monmaker_spiritsuffix4	妖精
exp_monmaker_spiritsuffix5	エッセンス
exp_monmaker_spiritsuffix6	幽霊
exp_monmaker_spiritsuffix7	悪鬼
exp_monmaker_spiritsuffix8	邪霊
exp_monmaker_spiritsuffix9	鬼火
exp_monmaker_statususerword1	シャーマン
exp_monmaker_statususerword2	オラクル
exp_monmaker_statususerword3	アウガー
exp_monmaker_strongfireprefix1	インフェルノ
exp_monmaker_strongfireprefix2	ブレイズ
exp_monmaker_strongfireprefix3	ノヴァ
exp_monmaker_stronglightningprefix1	ショック
exp_monmaker_stronglightningprefix2	サンダー
exp_monmaker_stronglightningprefix3	ブリッツ
exp_monmaker_strongpoisonprefix1	ヴェノム
exp_monmaker_strongpoisonprefix2	アシッド
exp_monmaker_strongpoisonprefix3	ベイン
exp_monmaker_strongshadowprefix1	ナイト
exp_monmaker_strongshadowprefix2	テラー
exp_monmaker_strongshadowprefix3	シャドウ
exp_monmaker_strongshadowprefix4	ヴォイド
exp_monmaker_strongwaterprefix1	デリュージ
exp_monmaker_strongwaterprefix2	フラッド
exp_monmaker_strongwaterprefix3	グレイシャー
exp_monmaker_strongwaterprefix4	ポーラー
exp_monmaker_summonerword1	サマナー
exp_monmaker_summonerword2	コンジャラー
exp_monmaker_summonerword3	コーラー
exp_monmaker_supporterword1	ブースター
exp_monmaker_supporterword2	サポーター
exp_monmaker_supporterword3	フィジシャン
exp_monmaker_supporterword4	エンチャンター
exp_monmaker_weakfireprefix1	ファイア
exp_monmaker_weakfireprefix2	フレイム
exp_monmaker_weakfireprefix3	アンバー
exp_monmaker_weakfireprefix4	ヒート
exp_monmaker_weaklightningprefix1	スパーク
exp_monmaker_weaklightningprefix2	ライトニング
exp_monmaker_weaklightningprefix3	ボルト
exp_monmaker_weakpoisonprefix1	ポイズン
exp_monmaker_weakpoisonprefix2	ブライト
exp_monmaker_weakpoisonprefix3	マック
exp_monmaker_weakpoisonprefix4	スラッジ
exp_monmaker_weakshadowprefix1	シェイド
exp_monmaker_weakshadowprefix2	ダーク
exp_monmaker_weakshadowprefix3	ダスク
exp_monmaker_weakshadowprefix4	グルーム
exp_monmaker_weakwaterprefix1	レイン
exp_monmaker_weakwaterprefix2	ウォーター
exp_monmaker_weakwaterprefix3	コールド
exp_monmaker_weakwaterprefix4	チル
exp_monmaker_weakwaterprefix5	フロスト
exp_monmaker_weakwaterprefix6	アイス
exp_monmod_firegod	炎神
exp_monmod_lightninggod	雷神
exp_monmod_physicalgod	剣神
exp_monmod_poisongod	毒神
exp_monmod_shadowgod	影神
exp_monmod_watergod	水神
exp_mysterydungeon_bossname	~ 神秘の王 ~
exp_mysterydungeon_bossvictory	#clr#神秘の王#ec#を倒しました！この旅は、#cc#魔法のポータル#ec#を使うと終了します。\n\n
exp_mysterydungeon_explanation	#big##clr#放浪者の旅#ec##endbig#\n\nこの冒険では#cy#最上階#ec#へ到達して、#clr#神秘の王#ec#を倒さなければなりません。モノの夢とは違い、村へ戻ることは#cr#できません#ec#！\n\nダンジョン内では#cy#上へ向かう階段#ec#しか見つからず、#cr#引き返す#ec#ことはできませんが、#cy#たき火のある階#ec#はたまに見つかります。\n\nダンジョン内では、まったく新しい#cy#魔物#ec#たちが待ち構えています。じっくり観察して、#cc#能力や行動パターン#ec#を学びましょう。幸運を祈ります！\n\n
exp_mysterydungeon_postvictory	#big##clr#放浪者の旅#ec#をクリア！#endbig#\n\n
exp_mysterydungeon_tip0	#clr#放浪者の旅#ec#では毎回新しい敵が出現するの。注意深く観察して！
exp_mysterydungeon_tip1	#clr#放浪者の旅#ec#では、強力で珍しい#clr#レリック#ec#が見つかるわ。
exp_mysterydungeon_tip2	#clr#放浪者の旅#ec#では村へ戻れないから、商人に会ったら、出し惜しみせずにお金を使って！
exp_mysterydungeon_tip3	#clr#放浪者の旅#ec#では数フロアごとに#cy#たき火#ec#が見つかる。効果的に活用して。
exp_obj_blackhole_name	ブラックホール
exp_overload_dmg_name	オーバーロード
exp_parry_down	受け流し低下！
exp_popup_misc_sticky	舌がくっつく！
exp_randomshop1_name	ノルマンド
exp_randomshop2_name	フェルナンド
exp_randomshop3_name	オルランド
exp_randomshop4_name	ヘルナンド
exp_randomshop5_name	タンド
exp_randomshop6_name	シランド
exp_rarity_relic	レリック
exp_shara_died	タングルディープでは数えきれない物語が、数えきれない形で語られる。今日に限れば、#cc#シャラの伝説#ec#はここで幕を閉じ、彼女の#cy#使命#ec#が果たされることはなかった。しかし、これは真の終わりなのだろうか？
exp_shara_dominate_description1	非元素系のエネルギーで敵1体を攻撃し、弱っている魔物を永久的に^tag1^する。最大^tag2^体の魔物を支配下に置ける。
exp_shara_dominate_description2	非元素系のエネルギーで敵1体を攻撃し、永久的に^tag1^して、大いなる使命に従わせる。最大^tag2^体まで支配下に置ける。
exp_shara_dominate_displayname1	懐柔の拳
exp_shara_dominate_displayname2	勧誘の叱責
exp_shara_dominate_displayname3	服従の一撃
exp_shara_dominate_displayname4	支配
exp_shara_dominate_extradesc1	精神力の^number1^の物理ダメージを与え、HPが^number2^以下の非チャンピオン系の敵を永久的に^tag1^する。ランク「超よゆう」以上の魅了された敵は、あなたのHPを回復する。
exp_shara_dominate_extradesc2	精神力の^number1^の物理ダメージを与え、HPが^number2^以下の非チャンピオン系の敵を永久的に支配する。支配下の魔物はゆっくりとHPを失う。ランク「超よゆう」以上の支配下の魔物が倒されると、あなたの最大HP、エナジー、スタミナの^number3^が回復する。
exp_shara_ko	多くの強敵と相まみえ、修羅場をくぐり抜けてきたシャラだったが、今回は<color=yellow>^tag2^</color>にて、<color=#0cffe6>^tag1^</color>に不覚を取った。それでもシャラの心は折れない。己が#cy#使命#ec#を果たす、その時まで。
exp_shara_ko_result	シャラは逃げる際に<color=yellow>^tag1^</color>Gを落とし、回復のために<color=#40b843>^tag2^ JP</color>を消費した。
exp_sharaending_text1	熱意に満ちた、謎多き冒険者さん...
exp_sharaending_text2	けど私が知りたいのは...
exp_sharaending_text3	あなたは敵なの？味方なの？
exp_sharaending_text4	誰にも使命の邪魔はさせない、けど...
exp_sharaending_text5	あなたとなら世界を救えるかもしれない...
exp_sharafinalboss_phase2begin_1	#cy#援軍ヲ要請シマス。#ec#現在の装備デハ、#cc#シャラ_アバター#ec#の攻撃に耐えられマセン。\n\n#cc#^tag1^タイムユニットの間、緊急修復モードに入りマス。\n\n
exp_sharafinalboss_phase2begin_2	アハッ！そんなに#cr#怖い#ec#の、ロボットさん？\n\n私はこの時のために力を磨いてきた。あなたがいないスキに、新しいお仲間たちを#cc#乗っ取って#ec#、襲わせてあげるわ！\n\n
exp_sharafinalboss_phase2end_1	修復サイクル完了。稼働状況: #cg#フル回復済み#ec#。\n\n
exp_sharaforest_levelname	夢幻の森
exp_sharamode_tips0	#cr#体力#ec#が満タンの時に#cc#魔法の泉#ec#を通過すると、#cc#エナジーシールド#ec#が補充され、クールダウンが解消されるわ。
exp_sharamode_tips1	シャラのレベルは#cy#JPを使って#ec#上げられ、武器のダメージや精神力が上昇していくの。
exp_sharamode_tips2	シャラの#cr#最大HP#ec#は、JPを使って#cy#メイン能力#ec#を強化するたびに増えていくわ。
exp_sharamode_tips3	#cy#パンドラの箱#ec#を開けるか#cy#たき火#ec#で休んで、新しいスキルを学んでいって。
exp_sharamode_tips4	選べるスキルは毎回ランダムに決定されるから、#cy#しっかり検討してから選択することね。#ec#。
exp_sharamode_tips5	隠されている#cg#サイドエリア#ec#の多くは、#cg#うわさ話#ec#を聞かなくても見つけられるわ。
exp_sharamode_tips6	シャラはたとえ危険な場所でも、#cy#スキルリスト#ec#からスキルを使用し、#cy#ホットバー#ec#を並べ替えられるの。
exp_sharamode_tips7	#cy#たき火#ec#の近くには必ず商人がいるわ。
exp_sharamode_tips8	#cc#シャラの物語#ec#では、#cy#パンドラの箱#ec#から必ず強力なギアが手に入るの。
exp_sharapower_learned_txt	#cc#シャラ#ec#は#cy#ミライ#ec#よりもスキルの扱いに長けています。スキルはホットバーへ割り当てなくても、#cy#スキルリスト#ec#から直接発動することができます。\n\nまた、たとえ危険なエリアでも、スキルをホットバーに#cy#セットしたり、外したり#ec#できます。#cg#サポートスキル#ec#についても同様です。\n\n
exp_skill_axeiaijutsu_name	斧の舞い
exp_skill_banish_description	非チャンピオン系の召喚獣や危険な罠を瞬時に破壊できる。
exp_skill_banish_displayname	霧散
exp_skill_boostdiscipline_desc	規律の最大値が^number1^上昇する。
exp_skill_boostdiscipline_name	規律強化
exp_skill_boostguile_desc	才知の最大値が^number1^上昇する。
exp_skill_boostguile_name	才知強化
exp_skill_boosthealth_desc	ライフの最大値が^number1^上昇する。
exp_skill_boosthealth_name	体力強化
exp_skill_boostspirit_desc	精神の最大値が^number1^上昇する。
exp_skill_boostspirit_name	精神強化
exp_skill_booststrength_desc	筋力の最大値が^number1^上昇する。
exp_skill_booststrength_name	筋力強化
exp_skill_boostswiftness_desc	俊敏の最大値が^number1^上昇する。
exp_skill_boostswiftness_name	俊敏強化
exp_skill_chakrashift_desc	自身の能力強化効果を吸収し、消滅させるが、^number2^ターンの間、除去した効果1個につき、与ダメージが^number1^上昇する。
exp_skill_chakrashift_name	チャクラシフト
exp_skill_charisma_desc	非チャンピオン系の盗賊タイプの敵が攻撃してきた時、^number1^の確率で^$sharamode:dominateverb$^する。
exp_skill_charisma_name	カリスマ
exp_skill_cleanup_desc	氷塊、炎、酸の池など、一時的な危険を及ぼすマスを瞬時に取り除く。
exp_skill_cleanup_name	磨きの極意
exp_skill_collectivestrength_desc	支配下の魔物1体につき、基本攻撃の与ダメージが^number1^上昇する（最大: ^number2^）
exp_skill_collectivestrength_name	力の結集
exp_skill_combatbiography_desc	すべての「筆法」を消費して、冒険について記した魔法の書を近くに召喚する。本を拾った瞬間、消費ぶんに^number1^を加えた「筆法」を回収し、かつ短時間、書道家のスキルが強化される。
exp_skill_combatbiography_extradesc	戦記は一度に一冊しか出現せず、^number2^ターン存続する。拾うと同時に^number4^ターンの間、書道家スキルの与ダメージが^number3^上昇する。
exp_skill_combatbiography_name	神秘の戦記
exp_skill_combatbiography_shortdesc	あらゆる「筆法」を網羅した魔法の書を、付近のマスへランダムに召喚する。
exp_skill_commandingpresence_description	（パッシブ）支配下の魔物1体につき、基本攻撃時に魔物を^$sharamode:dominateverb$^する確率を^number1^得る。
exp_skill_commandingpresence_extradesc	攻撃時に最大^number2^の確率で^$sharamode:dominateverb$^する。
exp_skill_commandingpresence_name	将の貫禄
exp_skill_createrandomrock_name	がれき生成
exp_skill_dangermagnet_desc	トラブルを招きやすい体質になり、敵との遭遇率が^number1^上昇する。
exp_skill_dangermagnet_name	危険な磁力
exp_skill_dominate_description	^$sharamode:dominatedesc$^
exp_skill_dominate_displayname	^$sharamode:dominatename$^
exp_skill_dominate_extradesc	^$sharamode:dominateedesc$^
exp_skill_elemabsorb_name	元素バリア
exp_skill_eshieldpower_desc	（パッシブ）エナジーシールドが砕け散った時に放出される力を利用し、新たにシールドを張り直すまで、与ダメージが^number1^上昇する。
exp_skill_eshieldpower_name	逆襲
exp_skill_essencestorm_desc	自身の生命力から強力なエネルギーの球体を^number1^個生成し、近くに敵がいる場合は毎ターンこの球体を放つ。
exp_skill_essencestorm_extradesc	一撃につき、精神力の^number2^の物理ダメージを与える。最大^number3^マス先の敵にもヒット。
exp_skill_essencestorm_name	エッセンスストーム
exp_skill_expmon_overdrive_name	オーバードライブ
exp_skill_expmon_photonbreath_name	フォトンの息
exp_skill_expmon_randomphoton_name	フォトンストーム
exp_skill_expmon_shielding_name	エナジーシールド
exp_skill_expmon_summoncannondrones_name	ドローン召喚
exp_skill_flowshield_description	命の粋からシールドを生成し、あらゆるダメージを吸収。シールドは最大HPの^number1^の耐久性を持つ。
exp_skill_flowshield_displayname	エッセンスシールド
exp_skill_flowshield_extradesc	クールダウンはシールドが破壊された時点で始まる。
exp_skill_forbiddance_desc	すべての「筆法」を消費して、目の前のマス上に強力な魔法のルーンを書く。ルーンに触れた敵は、「封印」と「足止め」を受ける。
exp_skill_forbiddance_extradesc	ルーンは「筆法」の数に応じて生成され、^number1^ターン存続する。「封印」と「足止め」の効果は^number2^ターン持続する。
exp_skill_forbiddance_name	禁忌
exp_skill_glide_desc	^number1^マス先までの短い距離を、優雅にジャンプする。
exp_skill_glide_extradesc	スキルは2回使うたび、クールダウンに入る。
exp_skill_glide_name	グライド
exp_skill_improveddominate_description	（パッシブ）HPが^number1^以下の敵でも、^$sharamode:dominatename$^を使って魅了できる。
exp_skill_improveddominate_name	威風堂々
exp_skill_inkcollector_desc	ランク「へっちゃら」以上の敵を倒すか、その攻撃をかわすか、クリティカルヒットが決まるたび、「筆法」がたまっていく。
exp_skill_inkcollector_name	インク集め
exp_skill_inkstorm_desc	あらゆる「筆法」を解き放ち、周囲の敵をランダムに激しく攻撃する。
exp_skill_inkstorm_extradesc	攻撃力の^number1^の物理ダメージを与える。「筆法」の数に応じて攻撃回数が増加。同一の対象を再攻撃時は^number2^のダメージを与える。「筆法」は発生しない。
exp_skill_inkstorm_name	墨汁嵐
exp_skill_lightningflash_desc	狙ったマスへ瞬時に駆け、到着と同時に周囲のすべてのマスに電撃を放つ。
exp_skill_lightningflash_extradesc	電気を帯びたマスに触れた敵を、^number1^ターンの間マヒさせる。
exp_skill_lightningflash_name	電光駆け
exp_skill_lightningscroll_desc	一直線に雷撃を放ってダメージを与え、しばらく残り続ける放電を発生させる。
exp_skill_lightningscroll_extradesc	攻撃力の^number1^、精神力の^number2^の雷ダメージを与える。「放電」に触れるたび、クリティカル率が^number3^上昇し、次の攻撃時に消費する。
exp_skill_lightningscroll_name	雷の巻物
exp_skill_menagerie_desc	自身が操るペットや召喚獣1体につき、ペットや召喚獣の与ダメージが^number1^上昇する。
exp_skill_menagerie_name	魔物使い
exp_skill_monstertoss_desc	近くの魔物1体を抱え上げ、別の敵へ投げつける。
exp_skill_monstertoss_extradesc	両方の敵に、投げた敵の現HPの^number1^のダメージを与える。
exp_skill_monstertoss_name	魔物トス
exp_skill_museofmelee_desc	^number3^ターンの間、基本的な近接攻撃が^number1^の確率で、^number2^の水、雷、または影脆弱性を付与。二刀流時は、それぞれの攻撃時に効果が発動する。
exp_skill_museofmelee_name	戦いの女神
exp_skill_necessarysacrifice_desc	魅了中の敵が倒された時、自身のスタミナとエナジーが最大値の^number1^回復する。
exp_skill_necessarysacrifice_name	補充
exp_skill_phasechange_desc	あらゆる魔物と位置を入れ替わり、混乱させる。
exp_skill_phasechange_extradesc	混乱は^number1^ターン持続する。
exp_skill_phasechange_name	コンバート
exp_skill_phasmashield_description	危険なファズマエネルギーの輪を召喚し、自身を取り囲む。触れた敵はダメージを受ける。
exp_skill_phasmashield_extradesc	毎ターン、精神力の^number1^と攻撃力の^number2^の火ダメージを与える。
exp_skill_phasmashield_name	ファズマリング
exp_skill_precisefinish_desc	威力は低いが、敵を倒した時の報酬が増える華麗な一撃。
exp_skill_precisefinish_extradesc	攻撃力の^number1^のダメージを与える。この攻撃で仕留めた敵からは、^number2^多くの報酬を得られる。
exp_skill_precisefinish_name	狙い撃ち
exp_skill_relichunter_desc	希少な遺物が無限の力を授けてくれる！装備中の「伝説」「レリック」「ギアセット」クラスのアイテム1個につき、^number1^のダメージと耐性を獲得。
exp_skill_relichunter_name	レリックハンター
exp_skill_retort_desc	次の物理攻撃を待ち構えて悠然とかわし、逆に攻撃者を封印状態にする。
exp_skill_retort_extradesc	回避ボーナスは^number1^ターンか、次に攻撃を受けるまで持続。攻撃者は^number2^ターンの間、封印を受ける。
exp_skill_retort_name	反ばく
exp_skill_rockcircle_name	生き埋め
exp_skill_scholar_desc	終わりなき知識の追求により、獲得するJPが^number1^増える。
exp_skill_scholar_name	学究の徒
exp_skill_shadowscroll_desc	恐ろしい影の爆発によって一帯を攻撃し、ダメージを与えると共に、残存する影のオーブを生み出す。
exp_skill_shadowscroll_extradesc	攻撃力の^number1^、精神力の^number2^の影ダメージを与える。対象の魔物は影脆弱性を受ける（効果は重複）。影のオーブは短時間、基本的な近接攻撃を^number3^強化する（効果は重複）。
exp_skill_shadowscroll_name	闇の巻物
exp_skill_shockwave_description	徐々に広がっていく稲妻をリンク状に召喚し、敵を攻撃する。
exp_skill_shockwave_extradesc	精神力の^number1^の雷ダメージを与える。
exp_skill_shockwave_name	衝撃波
exp_skill_sludgespread_name	ヘドロまき
exp_skill_subtletap_desc	敵の息の根を止めないていどに優しく殴る、近接攻撃。
exp_skill_subtletap_extradesc	攻撃力の^number1^のダメージを与えるが、HP 1以下にはならない。
exp_skill_subtletap_name	そっと撃
exp_skill_summontoxicslime_name	毒スライム召喚
exp_skill_treasuretracker_desc	隠された秘宝への鋭い嗅覚を発揮し、回復アイテムの^number1^が金貨の山となって出現する。
exp_skill_treasuretracker_name	お宝追跡
exp_skill_truehover_description	（パッシブ）浮遊術を極め、地上由来で受けるダメージが^number1^減少する。
exp_skill_truehover_name	真の浮遊
exp_skill_vanishingdodge_desc	HPが^number1^以下になった時、透明なインクが自身を包み込み、回避率が^number2^上昇する。
exp_skill_vanishingdodge_name	姿消しの墨汁
exp_skill_venomancerpoison_name	猛毒の刃
exp_skill_voidbolt_description	無のエネルギーを凝縮させて放ち、敵1体にダメージを与える。さらに毎ターン、生命力を吸い取る。
exp_skill_voidbolt_displayname	無の一撃
exp_skill_voidbolt_extradesc	攻撃力の^number1^の物理ダメージを与える。失っているHPに応じて、最大^number2^多くのダメージを与える。ダメージを受けた敵は^number4^ターンの間、毎ターン、現在のHPの^number3^を失う。
exp_skill_voidshield_description	命の粋から負のエネルギーシールドを生み出し、全ダメージを吸収する。シールドは最大HPの^number1^の耐久力を得る。シールドが有効中、確率によってランダムに「無の一撃」を放つ。
exp_skill_voidshield_displayname	無のシールド
exp_skill_voidshield_extradesc	「エッセンスシールド」とは併用不可。毎ターン、^number2^の確率で、付近の敵1体に「無の一撃」を放つ。
exp_skill_waterscroll_desc	一定範囲内を水攻めしてダメージを与え、しばらく残り続ける水蒸気を発生させる。
exp_skill_waterscroll_extradesc	攻撃力の^number1^、精神力の^number2^の水ダメージを与える。「濃霧」は火ダメージを抑制し、自身の回避率を^number3^高める。
exp_skill_waterscroll_name	水の巻物
exp_status_attackdown_name	ダメージ低下中
exp_status_brushstroke_desc	力をため、墨汁系攻撃と共に解き放つ。
exp_status_brushstroke_name	筆法
exp_status_combatbiography_boost_name	伝記ブースト
exp_status_dmgup_25_desc	与ダメージが^number1^上昇
exp_status_essencestorm_desc	エネルギーオーブを生成し、毎ターン、付近の敵1体に向けて放つ。#cy#残りのオーブ数:#ec# #cg#^$getactordata:essencestorm_ammo$^#ec#
exp_status_extracrit_desc	クリティカル率^number1^。次の攻撃またはスキル使用時に消滅する。
exp_status_flowshield_desc	エナジーシールドが全ダメージを吸収。#cy#シールドの残りHP:#ec# #cg#^$getactordata:flowshield_dmgleft$^#ec#
exp_status_parrydown_name	受け流し低下中
exp_status_robo_overdriveattack_name	オーバードライブ攻撃
exp_status_shadoworb_desc	近接武器による基本攻撃ダメージ^number1^
exp_superhardarea_name	神々の領域
exp_superhardarea_name_1	神々の領域 1階
exp_superhardarea_name_2	神々の領域 2階
exp_superhardarea_name_3	神々の領域 3階
exp_superhardarea_name_4	神々の領域 4階
exp_superhardarea_name_5	神々の領域 5階
exp_verb_charm	魅了
exp_verb_command	掌握
exp_verb_dominate	支配
exp_verb_recruit	勧誘
exp_wanderer_askgods	#cy#??? 放浪者#ec#: #cc#シャラを打ち負かした#ec#場所を探せ。#co#神々の領域#ec#への入り口が、そこで君を待っていよう。\n
exp_wanderer_dungeon1_desc	#big#報復の山#endbig#\n\n#cy#フロア数#ec#: 20\n#cy#難易度#ec#: #cr#^$gettext:difficulty_7$^#ec#\n^$gettext:md_startwithnothing$^\n^$gettext:md_ondefeat_loseprogress$^\n^$gettext:md_keeprelics$^\n\n^$gettext:md_monsters_respawn$^\n\n
exp_wanderer_dungeon1_name	報復の山
exp_wanderer_dungeon10_desc	#big#南国の秘宝#endbig#\n\n#cy#フロア数#ec#: 15\n#cy#難易度#ec#: ^$gettext:difficulty_5$^\n^$gettext:md_startwithnothing$^\n^$gettext:md_ondefeat_loseprogress$^\n^$gettext:md_keepgold_items_relics$^\n\n^$gettext:md_monsters_respawn$^\n^$gettext:md_jp_only_campfires$^\n^$gettext:md_more_consumables$^\n\n
exp_wanderer_dungeon10_name	南国の秘宝
exp_wanderer_dungeon2_desc	#big#精霊の寺院#endbig#\n\n#cy#フロア数#ec#: 30\n#cy#難易度#ec#: #cr#^$gettext:difficulty_8$^#ec#！\n#cy#開始条件#ec#: スキルと装備品を持ち込める\n^$gettext:md_ondefeat_loseprogress$^\n^$gettext:md_keepgold_items_relics$^\n\n^$gettext:md_monsters_respawn$^\n\n
exp_wanderer_dungeon2_name	精霊の寺院
exp_wanderer_dungeon3_desc	#big#キンピカエル大洞窟#endbig#\n\n#cy#フロア数#ec#: 15\n#cy#難易度#ec#: ^$gettext:difficulty_5$^\n^$gettext:md_startwithnothing$^\n^$gettext:md_ondefeat_loseprogress$^\n^$gettext:md_keepgold_relics$^\n\n^$gettext:md_monsters_respawn$^\n^$gettext:md_nodrops$^\n^$gettext:md_shopkeepers$^\n\n
exp_wanderer_dungeon3_name	キンピカエル大洞窟
exp_wanderer_dungeon4_desc	#big#守護者の廃殿#endbig#\n\n#cy#フロア数#ec#: 15\n#cy#難易度#ec#: ^$gettext:difficulty_5$^\n^$gettext:md_startwithnothing$^\n^$gettext:md_ondefeat_loseprogress$^\n^$gettext:md_keeprelics$^\n\n^$gettext:md_monsters_respawn$^\n\n
exp_wanderer_dungeon4_name	守護者の廃殿
exp_wanderer_dungeon5_desc	#big#王者の間#endbig#\n\n#cy#フロア数#ec#: 12\n#cy#難易度#ec#: #cr#^$gettext:difficulty_8$^#ec#\n#cy#開始条件#ec#: 能力値、装備品、スキルを持ち込める\n^$gettext:md_ondefeat_loseprogress$^\n^$gettext:md_keeprelics$^\n\n^$gettext:md_many_champions$^\n\n
exp_wanderer_dungeon5_name	王者の間
exp_wanderer_dungeon6_desc	#big#試練の塔#endbig#\n\n#cy#フロア数#ec#: 50\n#cy#難易度#ec#: #cr#^$gettext:difficulty_8$^#ec#!\n^$gettext:md_startwithnothing$^\n^$gettext:md_ondefeat_loseprogress$^\n^$gettext:md_keepgold_items_relics$^\n\n^$gettext:md_monsters_respawn$^\n\nこれぞ#cr#究極のチャレンジ#ec#！\n\n
exp_wanderer_dungeon6_name	試練の塔
exp_wanderer_dungeon7_desc	#big#戦慄の狩り#endbig#\n\n#cy#フロア数#ec#: 15\n#cy#難易度#ec#: #cr#^$gettext:difficulty_7$^#ec#\n^$gettext:md_startwithnothing$^\n^$gettext:md_ondefeat_loseprogress$^\n^$gettext:md_keepgold_relics$^\n\n^$gettext:md_monsters_respawn$^\n^$gettext:md_king_chaser$^\n\n
exp_wanderer_dungeon7_name	戦慄の狩り
exp_wanderer_dungeon8_desc	#big#混沌の工場#endbig#\n\n#cy#フロア数#ec#: 15\n#cy#難易度#ec#: ？？？\n#cy#開始条件#ec#: レベル1で開始。ギア、スキル、ペットなし、迷彩の香水10個\n^$gettext:md_ondefeat_loseprogress$^\n^$gettext:md_keeprelics$^\n\n^$gettext:md_monster_powerup$^\n^$gettext:md_monsters_respawn$^\n^$gettext:md_items_breakables$^\n\n
exp_wanderer_dungeon8_name	混沌の工場
exp_wanderer_dungeon9_name	山頂を目指して
exp_wanderer_dungeonlistbranch	#cy#??? 放浪者#ec#: どの物語も、そこへと向かう旅となる。語りが始まれば、君は旅が終わるまで、#cr#この世界に戻ってこれないかもしれん#ec#。真にのめり込める物語のみが、語るに値するものだからな。\n\n物語によっては#cy#持ち物#ec#や#cy#スキル#ec#を持ち込めず、物語が終わったあとで手元へ戻される場合もあるだろう。\n\nどの旅も成功を収めれば、他では決して手に入らない#cy#報酬#ec#を受け取れる。とはいえ勝利は容易ではなく、ふたつとして同じ物語は存在せんぞ。\n\n
exp_wanderer_firstvictory_1	#cy#??? 放浪者#ec#: よくぞ戻った、冒険者よ。\n\n我が語りを#cg#お楽しみ頂けた#ec#ようだな？\n\n
exp_wanderer_firstvictory_2	#cy#??? 放浪者#ec#: ある意味、#cg#それは正しい#ec#。\n\n君の見つけた#clr#レリック#ec#が、リュックの中に入っていないかな？\n\n
exp_wanderer_firstvictory_3	#cy#??? 放浪者#ec#: どうやって説明しようか。我が物語が#cc#巨大な湖#ec#だとしたら、君はそこを#cy#泳いできた#ec#。\n\n物語が終わった時、君は湖から上がった。その時、君が#cy#波紋#ec#を残していくように、一部の水は君についてきたのだよ。\n\nそう考えると、君が#clr#物語#ec#の中で見つけたものの一部が、#cy#目の前に現れても#ec#不思議はない。わかるかな？\n\n
exp_wanderer_firstvictory_4	#cy#??? 放浪者#ec#: 君ならわかると思った。こうした物語を分かち合える同志を、長いこと求めてきたのだ。語られるべき物語は、#cy#他にもたくさんある#ec#。\n\nふたつとして同じ旅は存在しない。語られるたびに姿を変え、そこでしか手に入らない#cg#報酬#ec#と#cr#試練#ec#が待ち構えているのだ。\n\n「#clr#山頂を目指して#ec#」は一番わかりやすい物語だった。では、残りの話も語ってやるとしよう。\n\n
exp_wanderer_firstvictory_response1	すごかったわ！実際あの場所にいるみたいだった。
exp_wanderer_firstvictory_response2	本当だ、入ってる...けど、こんなことって？！
exp_wanderer_firstvictory_response3	うん、他の物語も聞きたい！
exp_wanderer_mainbranch	#cy#??? 放浪者#ec#: こんにちは、旅の方。\n\n少し座って、川の流れを眺めていってはどうかな？\n\nこうした川は幼子と同じ。世界は壮大なタペストリーで、すべての糸に独自の#cy#旅#ec#が宿っている、ちがうかな？\n
exp_wanderer_mainbranch_askgods	#co#神々の領域#ec#はどこにあるの？
exp_wanderer_mainbranch_response1	あなたって冒険の経験が豊富そう。
exp_wanderer_mainbranch_response2	物語を聞かせて！
exp_wanderer_realmofgods_continue_1	#cy#??? 放浪者#ec#: これが私の真の姿だ。怖がらないでくれ。\n\n
exp_wanderer_realmofgods_continue_2	#cy#??? 放浪者#ec#: 私も君と同じ、冒険者でね。故郷を発ってから#cy#何千年#ec#もの間、この世界を旅してきた。そういった意味で、私は#cy#変わり者#ec#なのだよ。\n\n#co#神々の領域#ec#に暮らす仲間たちは、君たちのことや、#cg#タングルディープ#ec#のことには無関心なのでね。\n
exp_wanderer_realmofgods_continue_3	#cy#??? 放浪者#ec#: そのとおり。彼らは#cg#タングルディープ#ec#に暮らす者たちを見下している。価値のない民だと。ゆえに世界との#cr#関わりを断つ#ec#ことにしたのだ。\n\nだからこそ、君に故郷への行き方を教えたい。君は強く、たくましく、知恵が回り、#cg#計り知れない価値を持っている#ec#と証明してみせた。\n\n君なら#co#神々の領域#ec#へ挑み、#cg#勝利を掴める#ec#かもしれん。\n
exp_wanderer_realmofgods_continue_4	#cy#??? 放浪者#ec#: ありていに言えば、そうだ。こうでもしないと、彼らは#cy#君の強さを信じない#ec#。外界へも関心を向けない。私のどんな言葉よりも、君の行動が雄弁に語ってくれるのだ。\n\n私が道を教えたあとは、#cy#自由に我が故郷へ出入りできる#ec#ようになる。だが、彼らが#cg#温かく歓迎してくれる#ec#とは思わないほうがいい。\n\n君が今まで会ったことのない、#cr#恐るべき生物たち#ec#との戦いを覚悟しておくのだ。\n
exp_wanderer_realmofgods_continue_5	#cy#??? 放浪者#ec#: そう言うと思ったぞ、冒険者よ。よかろう！君に#co#神々の領域#ec#への道を教えよう。\n\n#cc#シャラ#ec#を打ち負かした場所へ戻れば、そこで入口が見つかるはずだ。\n\n
exp_wanderer_realmofgods_continue_responsebutton_1	美しいわ！
exp_wanderer_realmofgods_continue_responsebutton_2	彼らは家から出ないってこと？
exp_wanderer_realmofgods_continue_responsebutton_3	あなたの仲間と戦えってこと？！
exp_wanderer_realmofgods_continue_responsebutton_4	修羅場はくぐってきた、やってみせるわ！
exp_wanderer_realmofgods_intro_1	#cy#??? 放浪者#ec#: タングルディープの先にある世界を、その目で見てきたな？\n\n#cg#感じる#ec#のだ。\n
exp_wanderer_realmofgods_intro_2	#cy#??? 放浪者#ec#: 当然だろう、君は#cy#冒険者#ec#だ。ひとつの目標を達成すると、次の目標を求めたくなるもの...\n\nいずれ君は、あの世界について多くを学ぶ。冒険を続ける中で、いつか答えを見つけるだろうが...\n\n#cg#タングルディープ#ec#には、君もまだ知らない#cy#最後の謎がひとつ#ec#残っているのだ。\n
exp_wanderer_realmofgods_intro_3	#cy#??? 放浪者#ec#: 私は#cg#タングルディープ#ec#と、その上に広がる#cy#無限の大地#ec#との境目からやって来た。そこは大昔に世界へ刻み込まれた場所。誰がそうしたのかは言えんがな。\n\nそこでは#cr#恐ろしい獣#ec#や#cc#古代の精霊#ec#、そして無限の力を持つ#cs#ロボットたち#ec#が暮らしている。奇妙な場所だとは思わんか？彼らの全員が平和に共存し、そこを故郷と呼んでいるのだ。\n\nこの地には、#cy#忘れられて久しい言語#ec#で与えられた呼び名がある。君の言葉に翻訳すれば、#co#神々の領域#ec#といったところだ。\n
exp_wanderer_realmofgods_intro_4	#cy#??? 放浪者#ec#: もちろん今から教えよう。だが、その前にひとつ話しておきたい。私はすべてを晒してはいなかった...\n\n実のところ、私もまた#cc#古代の精霊#ec#なのだ。正体を見せよう。\n
exp_wanderer_realmofgods_intro_responsebutton_1	うん、美しかった！質問が山ほどあるの...
exp_wanderer_realmofgods_intro_responsebutton_2	どういう謎？他に何があるの？
exp_wanderer_realmofgods_intro_responsebutton_3	どうすれば行けるの？
exp_wanderer_realmofgods_intro_responsebutton_4	！！！
exp_wanderer_selectdungeon_confirm	この旅を始める
exp_wanderer_selectdungeon_no	戻る
exp_weaponmaster_statue_name	武器マスターの像
exp_weaponmaster_statue_text	あらゆる武器や戦術を極めた、#cy#強力な戦士#ec#の像が立っているわ。\n\n辺りには慈悲深いオーラと#cc#フロウ#ec#が舞っていて、まるで私に#cg#知識の断片#ec#を授けたいかのよう。\n\nここで瞑想すべき？\n
glitterskin_status_desc	近接攻撃者が盲目になり、^number2^ターンの間、命中率が^number1^下がる
intro_dualwielder	あらゆる物語は羽ペンと墨から生まれる。\n時に大胆に、時に繊細に。\nそれが私の書道であり、生き方。\n今日が私のキャンバスとなる。
item_armor_heavyarmor5_desc	この鎧の装飾って...ちょっとやりすぎ。しかもピカピカに磨き上げられてる。実戦で一度も使われていないのは明らかね。特別な機会にしか着用されなかった鎧に違いないわ。
item_armor_heavyarmor5_name	儀礼の鎧
item_armor_lightarmor5_desc	このローブを羽織ると、守護霊に見守られているように感じる。転びそうになると、うまくバランスを取ってくれるの。こんなに薄いのに、これだけ安心できるって、ちょっと想像を超えているわ。
item_armor_lightarmor5_name	古代のマント
item_armor_mediumarmor5_desc	ミスリル製の鎖に光が当たって、まるでスパンコールのドレスみたいにきらきら輝いてる！しかも普通のドレスとは違って、体をばっちり守ってくれるし。完ぺき！
item_armor_mediumarmor5_name	ミスリルの鎖帷子
item_armor_shield6_desc	この紋章は知ってる。前に本で見た。とある神秘的な王国のものよ。長老たちはただの伝説だって言ってたけど、私はいつだって実在すると信じていた！
item_armor_shield6_name	王家の盾
item_bomb_confusetraps_desc	以前これの詰まった箱が、モンスター牧場の近くで開いちゃった時、ジェセは一日がかりで魔物たちをかき集めたって聞いたわ。
item_bomb_confusetraps_effectdesc	魔物が踏むとガスが噴出し、方向感覚を失わせる。罠は^number1^ターン存続し、混乱効果は^number2^ターン持続する。
item_bomb_confusetraps_name	混乱の罠
item_item_gem8_desc	どういうわけか、リヴァーストーン村では今この金属が流行ってるみたい。特に頑丈でもないし、黄金のように光るわけでもない。おまけに重いし！
item_item_gem9_desc	タングルディープいち硬い宝石。これほどの希少品でなければ、その辺の石ころみたいに魔物へ投げつけてやるんだけど。
item_weapon_2hsword6_desc	こういった剣を持つと、熟練の兵士ですら限界を超えられるもの。過去の偉大な伝説に泥を塗らないよう、もっと武勇を磨かなきゃだめね。
item_weapon_2hsword6_name	バスターソード
item_weapon_axe6_desc	しばらく考えてるんだけど、こうした黄金の武器とかってお金の代わりになるのかな？一体どこの素敵なお金持ちさんが、こうしたモノを造ってるわけ？今度ケイティに訊いてみよっと。
item_weapon_axe6_name	アウレリアヌスの斧
item_weapon_bow6_desc	この弓で狙っていると、慈悲深い何かが手を導いてくれるように感じる。獲物を仕留めるための危険な道具でも、なぜだか心が安らぐわ。
item_weapon_bow6_name	天使の弓
item_weapon_claw6_desc	大きな牙！きっと巨大な魔物のものね。こうした牙がずらりと並んでいる姿は見たくない。それと、この牙をもぎ取った者とも対峙したくない。
item_weapon_claw6_name	原始の牙
item_weapon_dagger6_desc	自分の武器に見張られているような感覚には、決して慣れそうにない。特に私が攻撃をミスるたび、咎めるように見られるのは、ね。
item_weapon_dagger6_name	悪夢のスパイク
item_weapon_mace6_desc	これは残忍なエモノね。どこまでも武骨で、洗練さのカケラもなくて。こういった武器を見ていると、「ぶっ潰せ！」って言葉が自然と頭に浮かんでくるわ。
item_weapon_mace6_name	フランジクラッシャー
item_weapon_spear6_desc	槍に赤い布を巻いただけで、こんなにも格好よく見えるなんて驚き。けど、戦闘中にこの布を踏んですっ転んでしまう冒険者たちも、多かったんじゃないかな。
item_weapon_spear6_name	薙刀
item_weapon_staff6_desc	この杖を使い始めてから、楽しい夢ばかり見るようになった。目覚めも良くなったし。まるでこの杖の発する光が、心を癒してくれるみたい。
item_weapon_staff6_name	ルミナリエ
item_weapon_sword0_desc	墨汁は書道家の命よ。羊皮紙に記した筆跡のすべてが、自身の手足となるの。私は必死で努力して、ようやくこの教えを理解した。今こそ歴史の中に、自分の一ページを書き込む時ね。
item_weapon_sword0_name	稽古の筆
item_weapon_sword6_desc	本当に軽くて、バランスの良い剣。まるで夢を携えているかのよう。夢といっても、魔物たちをその場で切り裂いてしまう夢だけど。
item_weapon_sword6_name	天空の剣
lightningdebuff30_name	雷脆弱化
log_bankrelic	レリック「^tag1^」を取り置きした。\n\nダンジョンをクリアすると#cy#銀行#ec#で受け取れる！\n\n
log_error_know_skill	そのスキルは#cr#もう習得済み#ec#です！
log_keeprelic	レリック「^tag1^」を入手した。\n\nこの旅を終えると消滅する。\n\n
log_mon_terrain_power	#cy#^tag1^#ec#は#cy#^tag2^#ec#の中で、#cg#より強くなっている#ec#！
log_monster_died_shara	^tag1^を倒した！<color=#40b843>^tag2^</color>JPと<color=yellow>^tag3^</color>Gを獲得！
log_oilslick_poison_damage_up	<color=yellow>オイル池によって毒ダメージが悪化！</color>
log_robot_summon	#cy#^tag1^#ec#が鉄くずから、別の#cy#^tag1^#ec#を組み立てた！
log_shara_creatureheal	あなたは#cc#支配下#ec#の魔物から、#cy#^tag1^#ec# HPを受け取った！
log_shara_maxcreatures	これ以上の魔物は#cr#支配できない#ec#！（最大: #cy#^tag1^#ec#）
log_shield_absorb_damage_attack	<color=#ffc80a>^tag1^</color>が<color=#ffc80a>^tag3^</color>をヒットし、#co#^tag2^#ec#ダメージ！（#cc#シールドで吸収！#ec#）
log_shield_absorb_damage_effect	<color=#ffc80a>^tag1^</color>が<color=#ffc80a>^tag3^</color>をヒット！#cy#^tag4^#ec#によって#co#^tag2^#ec#ダメージ！（#cc#シールドで吸収！#ec#）
md_items_breakables	#cc#特殊条件#ec#: 木箱などから得られるアイテムが増加！
md_jp_only_campfires	#cc#特殊条件#ec#: たき火でのみJPを獲得！
md_keepgold_items_relics	#cy#成功時#ec#: ダンジョン内で拾ったすべての#cy#お金#ec#と#cg#アイテム#ec#、1つ以上の#clr#レリック#ec#を獲得
md_keepgold_relics	#cy#成功時#ec#: ダンジョン内で拾ったすべての#cy#お金#ec#と、1つ以上の#clr#レリック#ec#を獲得
md_keeprelics	#cy#成功時#ec#: ダンジョン内で拾った#clr#レリック#ec#を1つ以上獲得
md_king_chaser	#cc#特殊条件#ec#: #clr#神秘の王#ec#が最初から追ってくる！
md_lowmonsteraggro	#cc#特殊条件#ec#: 魔物があまり襲ってこない！
md_many_champions	#cc#特殊条件#ec#: 魔物が少なく、チャンピオンが多い！
md_mini_dreamcaster_explain_text	#cy#ミニドリームキャスター#ec#: 使用手順は以下の通りデス。\n\n#cy#装備品#ec#、#cc#夢見のオーブ#ec#、#co#お金#ec#をユニットに投入しマス。\n\n装備が強化されマス。場合によっては#co#魔法特性#ec#も追加されマス。\n\n#cy#ミニドリームキャスター#ec#は使用後、#cr#自爆シマス#ec#。\n
md_mini_dreamcaster_main_response0	かわいい！何をしてくれるの？
md_mini_dreamcaster_main_response1	ギアを強化して！
md_mini_dreamcaster_main_text	#cy#ミニドリームキャスター#ec#: #cg#現在の状態: 小さいけれど稼働中。#ec#\n
md_mini_dreamcaster_orbselect_text	#cy#ミニドリームキャスター#ec#: 使用する#cy#夢見のオーブ#ec#を選んでくだサイ。#cc#明晰のオーブ#ec#か#cg#スキルオーブ#ec#を選択すると、オーブに付随する魔法特性が付与されマス。\n
md_mini_dreamcaster_upgrade_text	#cy#ミニドリームキャスター#ec#: 強化したい装備品を選んでくだサイ。強化には#cy#夢見のオーブ#ec#が1個必要デス。#cg#オーブは装備品を選んだあとで、選択できマス。\n\n#cy#警告: このミニドリームキャスターは一度しか使えまセン。使用後に#ec##cr#自爆シマス#ec#。\n
md_monster_powerup	#cc#特殊条件#ec#: 魔物同士で戦い、勝者がレベルアップ！
md_monsters_respawn	#cc#特殊条件#ec#: 魔物が復活する！
md_more_consumables	#cc#特殊条件#ec#: 消耗品が多く出現！
md_nodrops	#cc#特殊条件#ec#: 魔物がアイテムやギアを落とさない！
md_ondefeat_loseprogress	#cy#失敗時#ec#: ダンジョン内での進捗をすべて失う
md_randomshop_intro_txt	#cy#^$npcname:current$^:#ec# やあ、こんにちは！当店の#cc#ステキな商品#ec#を見ていっておくれよ。食べ物はもちろん、武器や防具、それにちょいと変わった代物まで、幅広く取り揃えてあるからさ！\n
md_shopkeepers	#cc#特殊条件#ec#: すべてのフロアで商人が出現！
md_startwithnothing	#cy#開始条件#ec#: レベル1で開始。ギア、スキル、ペット、アイテムなし
misc_scaryface	怖い顔！
misc_shape_flexrect	レクタングル
misc_shape_semicircle	セミサークル
mm_dualwielderemblem_tier0_biography_desc	戦記を拾うと同時に^number2^ターンの間、回避率が^number1^上昇する。
mm_dualwielderemblem_tier0_dualwield_desc	二刀流時、基本攻撃の与ダメージが^number1^上昇
mm_dualwielderemblem_tier1_glide_desc	「グライド」使用時に「筆法」を獲得
mm_dualwielderemblem_tier1_shadow_desc	影ダメージが、敵の耐性の^number1^を貫く
mm_dualwielderemblem_tier2_brush_desc	移動中、^number1^の確率で「筆法」を獲得
mm_dualwielderemblem_tier2_dodge_desc	回避時に、あらゆるクールダウンが^number1^ターン減少
mm_elemental_bolt_desc	精霊の怒り
mm_elemental_bolt_name	ダメージを与える示現スキルを使用時、^number1^の確率でランダムに敵をヒットし、最後に使用した元素にて、精神力の^number2^のダメージを与える。
mm_elemental_bolt2_name	精霊の一撃
modedescription_adventure_shara	<color=#40b843>冒険モード</color>\nライフが0になると、<color=#40b843>シャラのキャンプへ戻ります</color>。\n所持金と未使用のJPが半分になります。\n<color=#40b843>ローグライクゲームの初心者</color>におすすめです。\n\n
modedescription_heroic_shara	\n<color=#ffc80a>英雄モード</color>\nライフが0になるとゲームオーバー。<color=red>最初からやり直し</color>です。\n<color=#ffc80a>手ごわい</color>ですが、<color=yellow>本来のシャラの物語をお楽しみいただけます</color>。\n\n
mon_voidcrystal_name	無の水晶
monster_attr_liveinwater	水棲型
mysteryking_chaser_powerup_txt	あなたを追ってきた#clr#~ 神秘の王 ~#ec#がすべての力を解き放ちました！\n\n#cy#本当の戦い#ec#に備えましょう...\n\n
npc_jumpintoriver_name	リヴァーストーン運河への道
obj_holyfire_name	天界の炎
relic_flavor_no_owner	謎の英雄
relic_option_goback	#cy#元のアイテム#ec#を再確認
relic_option_keep	この旅でレリックを使う。旅が終わった時に#cr#消滅#ec#します。
relic_option_wait	この旅を#cy#クリア後#ec#、レリックを受け取る。レリックのランクはダンジョン外でのレベルに応じて#cg#変動#ec#します。
relic_tutorial_text	#clr#レリック#ec#はランダムに生成される、特殊な効果を持った装備品です。#co#伝説アイテム#ec#や#cg#ギアセット#ec#より強力なレリックもあります。#clr#レリック#ec#は#cy#放浪者の旅#ec#の中でしか、手に入りません。\n\n#clr#レリック#ec#は、#clr#旅#ec#のラスボスである#cy#神秘の王#ec#を倒すと、確実に1個手に入ります。ダンジョン内でも見つかることがあります。\n\n
relic_tutorial_text2	ボスの前に見つけた#clr#レリック#ec#は、その場で入手して残りの#cy#旅#ec#に用いる（ただし、クリア時に#cr#消滅#ec#します）か、ボスを倒したあとで#cg#報酬#ec#として受け取るか、選ぶことができます。\n\n#cy#報酬#ec#として受け取る場合、レリックのランクはダンジョン外でのレベルに応じて変動します。\n\n#clr#レリック#ec#は、ダンジョン内で使いたい場合は#cr#外へ持ち出せず#ec#、報酬にしたい場合はボスに#cg#勝たないと#ec#受け取れないので、慎重に選択しましょう。\n\n
shadowdebuff30_name	影脆弱化
shara_ability_update_text	己の#cc#使命#ec#がより明確になった！#cy#^$sharamode:prevdominatename$^#ec#のスキルが、#cc#^$sharamode:dominatename$^#ec#に進化しました。\n\n^$sharamode:dominatedesc$^\n\n
shara_ability_update_text_addendum	<size=46>支配スキルを極めた！</size>\n\nあなたの#cc#支配#ec#スキルでは今後、支配下の魔物たちはプレイヤーを回復する能力を失い、#cr#時間と共にHPが減少していきます#ec#。\n\nランク「超よゆう」以上の#cc#支配下#ec#の魔物が#cy#やられた#ec#場合、あなたは自身の最大HP、スタミナ、エナジーの#cg#15%#ec#ぶん回復します！\n\n
shara_stat_boost_counter	（購入数: ^tag1^）
skill_expmon_absorbpowerups_name	アイテム吸収
skill_expmon_adhesivetongue_name	ねばつく舌
skill_expmon_batterup_name	ボコボコ！
skill_expmon_boulder_slam	沼クラッシュ
skill_expmon_burstgas	猛毒バースト
skill_expmon_burstgas_name	毒バースト
skill_expmon_cannonstunner_name	キャノンスタナー
skill_expmon_cubeslimesummonreaction_name	カクカクジェリー分裂
skill_expmon_divinepower_name	天界のオーラ
skill_expmon_eatweapon_name	武器食い
skill_expmon_fireball_name	ファイアボルト
skill_expmon_fly2_name	飛翔
skill_expmon_glitterskin_name	ギラギラ肌
skill_expmon_healovertime_name	自動回復
skill_expmon_holystorm_name	聖なる嵐
skill_expmon_icepotion_name	フロストポーション
skill_expmon_megabolt_name	ギガボルト
skill_expmon_mudfighter_name	泥ファイター
skill_expmon_multibite_name	バイトストーム
skill_expmon_passive_dodge25	巧みな回避
skill_expmon_passive_dodge25_name	回避率上昇
skill_expmon_passivescare_name	怖い顔
skill_expmon_resilient_name	ねばり腰
skill_expmon_slimehex_name	メガヘクス
skill_expmon_staffcharge_name	棒の制裁
skill_expmon_stagrush_name	スタグラッシュ
skill_expmon_statusresist50_name	状態異常耐性
skill_expmon_stealandeatfood_name	飲み込み
skill_expmon_stickyshot_name	べとべとショット
skill_expmon_transferhealth_name	ライフ転送
skill_expmon_waterfighter_name	水の戦士
skill_expmon_wingslash_name	羽斬り
skill_noroot_nostun_name	失神耐性
skill_playerglitterskin_desc	^number1^ターンの間、自身と仲間がまばゆい肌で覆われ、近接攻撃者の目をくらませる。
skill_playerglitterskin_edesc	盲目になった敵は^number3^ターンの間、命中率を^number2^失う
skill_playerspinblade_desc	回転して飛んでいく刃を生成し、毎ターン、ダメージを与える。受け流し率が一瞬、上昇する。
skill_playerspinblade_edesc	刃が攻撃力の^number1^の物理ダメージを与える。^number3^ターンの間、受け流し率が^number2^上昇する。
skill_playerspitice_desc	氷のつばを吐き、距離が遠いほど大ダメージを与える。一瞬、自身の精神力が上昇する。
skill_playerspitice_edesc	精神力の^number1^の水ダメージを与える。対象との間のマス1つごとに、^number2^の追加ダメージを与える。^number4^ターンの間、自身の精神力が^number3^上昇する。
skill_summonvoidcrystal_desc	長射程のレーザーを2回放ってから消滅する、固定型の無の水晶を生成する。
skill_summonvoidcrystal_extradesc	威力はプレイヤーのレベルに準ずる。一度に複数の無の水晶を召喚することも可能。
skill_xp_bladefroghop_name	ブレードホップ
tutorial_exp_campfire_text	#cc#シャラの冒険#ec#では、#cc#3フロアごと#ec#に#cy#たき火#ec#が見つかります。たき火のフロアでは回復や、新しい#cc#スキル#ec#の習得、さらに商人から#cy#道具#ec#を買うこともできます。\n\nこの束の間の休息を活用して、冒険のプランを練りましょう！\n\n
tutorial_exp_sharamode_maxcreatures_text	シャラの#cc#^$getstring:sharaabilityname$^#ec#のスキルは、一度に#cy#限られた数#ec#の魔物しか支配できません。すでに、#cy#^$getstring:sharamaxcreatures$^#ec#体の魔物を支配下に置いている場合、それ以上の魔物を魅了することはできません。\n\nしかし、このスキルはストーリーの進行に合わせて#cc#強化されます#ec#！重要なイベントが終わったら、必ずスキルの説明を確認しましょう。\n\n
tutorial_exp_sharamode_part1_text	#cc#シャラの冒険#ec#へようこそ。このゲームモードでは、新しいゲームシステムで新しい視点から、#cg#タングルディープ#ec#の物語をお楽しみいただけます。メインストーリーの#cy#第3のボス#ec#をまだ倒していない方は、先にそちらをクリアしましょう！\n\nこのモードでは#cg#回復の小びん#ec#を使えない代わりに、魔法の泉に触れた瞬間、ライフなどが少し回復します。また、#cy#リヴァーストーン村#ec#を訪れることはできないため、#cy#ポータル#ec#は別の場所へワープする時のみ使用します。\n\nすなわちドリームキャスターや魔法の果樹園、モンスター牧場は一切登場しません...\n
tutorial_exp_sharamode_part2_text	シャラは#cy#経験値#ec#を獲得せず、#cg#JP#ec#を使ってスキルを学ぶこともできません。代わりにスキル画面では、#cg#JP#ec#を使って能力を強化できます。強化コストは毎回上昇していきます。\n\nスキルの習得法は2つ。1つは、#cy#パンドラの箱#ec#を開けて、他のジョブのスキルを学ぶこと。ランダムに出現するスキルの中から、1つのスキルを学ぶことができます。\n\nまた、たき火で休んだ時にも、#cc#シャラ専用#ec#のスキルを1つ習得できます。出現するスキルは#cy#プレイのたびに変化する#ec#ので、慎重に選びましょう。\n\n
tutorial_exp_sharamode_wanderingmon_text	#cy#シャラ#ec#が強くなって存在が知れわたると、#cg#タングルディープ#ec#の魔物たちが襲ってこなくなります。#cy#どのフロア#ec#でも、たくさんの魔物を倒して力を示したあとは、#cr#新しい魔物が出現しなくなります#ec#。\n\n
wanderer_intro_1	#cy#??? 放浪者#ec#: うん、まあそうか。ただ、私は#cc#川#ec#が連れていってくれる場所へ行くだけ...\n\n一方の君は、#cy#我が道を切り開いていく#ec#者に見える。できれば漫然と漂うのではなく、流れに逆らって泳いでいきたい。\n\nちがうかな？\n
wanderer_intro_2	#cy#??? 放浪者#ec#: 私はただの老いぼれだ。ひとつの若木から森が生まれ、立派なジャングルへ成長していく様をこの目で見てきた。君に語るべき物語は山ほどある。この場所だけでなく、#cg#タングルディープの彼方#ec#についても。\n\nだが、君は物語に身を捧げねばならん！\n\n心が旅をすれば、体も旅をできるもの。新しい経験を恐れるな。広い心でぶつかってゆけ。そうすれば、果てしない#cc#発見の海#ec#が君を待っていよう。\n
wanderer_intro_3	#cy#??? 放浪者#ec#: 私は単なる語り部だ、冒険者よ。真に#cy#心を開く#ec#覚悟ができているなら、ひとつ話してやってもよい。\n\nが、少しでも疑念を抱いているなら、#cy#真の没入感#ec#は得られんし、君をこの旅へ誘ってもやれん。\n\n場合によっては#cg#装備も、スキルも、ペットも、アイテム#ec#も、すべて取り上げられてしまうだろう。#cy#我が語りを聞く#ec#準備はよいか？\n
wanderer_intro_4	#cy#??? 放浪者#ec#: おお、戻ったか！我が語りの途中で、#cy#意識をなくしてしまってな#ec#。上質な物語に#cy#のめり込む#ec#と、こうしたことが起きるものだ。\n\n語りを終えられなかったゆえ、次回はまた、最初からやり直しとなるぞ。もちろん、細かい部分は#cy#毎回変わってしまう#ec#ため、何が起きるかは誰にも予想できん。\n\n準備はよいか？\n
wanderer_intro_5	#cy#??? 放浪者#ec#: よかろう！では、「#clr#山頂を目指して#ec#」を語るとしよう。\n\n君が向かうのは、驚異的な旅が始まる場所。#cy#今まで見たことのない#ec#生き物たちが、うごめいている世界だ。そして強風の吹きすさぶ、雄々しき山の頂には、計り知れない価値を持つ#clr#レリック#ec#が眠っている...\n\nそんなところだ。さあ、目を閉じて、#cg#我が言葉に耳を傾けよ#ec#...\n\n
wanderer_intro_response1	釣り人っていうか賢人みたい。
wanderer_intro_response2	タングルディープの先へ行ったの？！他には？
wanderer_intro_response3	待って、他にやることが。
wanderer_intro_response4	準備はできてるわ、聞かせて！
waterdebuff30_name	水脆弱化
xp_obj_staticparalyzer_name	電気エネルギー
exp1_obj_dominator_head_name	トロフィー