abil_skill_summonvoidcrystal_name	召唤虚空水晶
boost_stat_level_up_var	获得<color=yellow>^tag2^</color> <color=#0cffe6>^tag1^！</color>
boostattack_after_move_desc	你下一次的近战攻击将造成^number1^伤害
calligrapherskill50_desc	^number1^书法家技能伤害
des_obj_confusetrap_dname	混乱陷阱
description_escapeportal_shara	使用后即可在特定边缘区域进行快速旅行。
dialog_comparerelic_txt	<size=50>^$getstring:leg_origname$^ （自适应等级）</size>\n\n<color=#ffc80a>传奇物品 ^$getstring:leg_origtype$^</color>\n\n^$getstring:scaledleg_info$^\n
dialog_friendly_dirtbeak_shara_1	#cy#（嘎嘎）#ec#你是谁啊？！胆子真大，竟敢到我的地盘上来！我是#cy#污喙公爵#ec#，是#cy#鸟人兄弟#ec#的领袖……呃，我是他们之中最强大的鸟，你……你最好……\n\n
dialog_friendly_dirtbeak_shara_1_response	我最好如何？
dialog_friendly_dirtbeak_shara_2	我……我决定对你好，女士。因为我是#cy#最好#ec#的人。不像那些在我#窝里#ec#叽叽喳喳的白痴！
dialog_friendly_dirtbeak_shara_2_response	那些白痴把你从家里赶出来了？
dialog_friendly_dirtbeak_shara_3	我是纷乱深渊中最大只、最厉害的鸟！但鸟人兄弟中的一只家伙发现了这叠#cc#订装在一起的奇怪纸张#ec#。而其他的兄弟们会……那不重要！纸真#cy#讨厌#ec#。\n\n这些讨厌的纸开始让兄弟们叫嚷着要……鸟……鸟民当窝作主？他们居然说想要#cy#投票#ec#选择谁来当老大！\n\n
dialog_friendly_dirtbeak_shara_3_response	那他们就是一群傻瓜蛋！
dialog_friendly_dirtbeak_shara_4	我和你一样，也是被一群自以为是的人赶出了自己的家园。而且我能看得出，你身上有着和我一样的领袖气质，你是那么#cy#强大而坚毅#ec#。我会帮你夺回你应有的一切。只要我们#cy#携手合作#ec#，就肯定能让他们见识到那些漂亮的空话是多么软弱无力！\n\n
dialog_friendly_dirtbeak_shara_5	嘎！从未有人跟我说过这么动听的话……不对，其他鸟每天都会称赞我，说我有多强大！我们可以一起变得更强大！让我们一起#cy#教训那些废物#ec#吧，#cc#蓝鸟#ec#！我在我的巢穴等你。\n\n
dialog_friendly_dirtbeak_shara_6	这样就对了，公爵！还有，叫我#cc#萨拉#ec#就行啦。现在我们是朋友了，任何人都无法阻挡我们！我准备一下就去你的巢穴找你。\n\n
dialog_friendly_dirtbeak_shara_7	我和#cy#鸟人兄弟#ec#正在保护我们的地盘，正如你所要求的一样。\n\n
dialog_learnskill_fromitem_button1_text	学习技能（500职业点数）
dialog_learnskill_fromitem_button2_text	不学习
dialog_relic_compareoriginal	^$getstring:nonscaled_legtext$^
dialog_relic_found_main_txt	<size=50><color=#ffc80a>FOUND</color> ^$getqstring:leg_item$^！</size>\n\n<color=#ffc80a>Legendary ^$getqstring:leg_type$^</color>\n\n^$getqstring:leg_info$^\n\n^$getqstring:leg_desc$^\n
dialog_shara_boss1_postfight_1	喂喂喂，别激动！我们……呃，我清点了投票数，然后……似乎你是老大了，污喙公爵！\n\n#cy#啾啾啾#ec#……\n\n
dialog_shara_boss1_postfight_2	#cr#嘎！#ec#现在是谁赢了，臭小子们？我又再次当上#cc#栖木公爵#ec#了！#cc#污喙#ec#比那些#cc#愚蠢的书#ec#要强大得多，给我牢记这一点！\n\n
dialog_shara_boss1_postfight_3	听好了，这是我作为公爵颁布的第一条新法令：我会大发慈悲，开放我们偷来的高级食物补给，你们这些家伙负责用它们制作一顿大餐！或许你们可以把那些蠢书当柴火用！\n\n
dialog_shara_boss1_postfight_4	我好久没像这样饱餐一顿了。谢谢你，污喙。\n\n在#cy#强而有力的领导之下#ec#，#cy#鸟人兄弟#ec#肯定会为你鞠躬尽瘁。他们需要你的力量。我也需要。\n\n
dialog_shara_boss1_postfight_5	我的未来还有很长一段路要走，如果能有一处让我歇息的地方，我会轻松不少。你可以确保这地区的安全并消除所有威胁吗？\n\n
dialog_shara_boss1_postfight_6	小事一桩，#cy#蓝鸟#ec#！我和#cy#鸟人兄弟#ec#会确保你安全无虞。\n\n如果有#cc#溪石营地#ec#的蠢货们经过这里呢？我们可以抢他们的东西吗？\n
dialog_shara_boss1_postfight_7	只要能保证你们安全富足，你和你的#cy#兄弟#ec#该怎么办就怎么办。住在#cc#溪石#ec#的那些懒骨头简直就像活在蜜罐里一样，抢他们一点东西不会有什么影响的。\n\n万事小心，#cy#污喙#ec#。我很快就会回来的。\n\n
dialog_shara_boss1_postfight_8	你说了算！不过，#cy#嘎#ec#……还有一件事。外面的#cy#强盗们#ec#不见得个个都有脑子，知道要服从我这位包容、强大的领导。其实……这房间里的鸟就是#cy#鸟人兄弟#ec#全员了。\n\n所以如果你遇见了哪个不开眼的强盗，需要收拾他们的话，不用手下留情。我很快就会把他们收入麾下！\n\n
dialog_shara_boss1_prefight_1	大家快看啊！#cr#傻鸟公爵#ec#又回来了。\n\n我们不需要你来吃光我们的食物，还对我们颐指气使！我们是纷乱深渊#cy#最厉害的强盗#ec#！\n\n
dialog_shara_boss1_prefight_2	你最好别乱说话，因为这次我不再是一只孤鸟！我和我的朋友#cc#萨拉#ec#就来教教你们什么叫“#cy#尊重#ec#”。
dialog_shara_boss1_prefight_3	就因为别人和你们不同，你们就要把自己的同类赶走吗？他无法控制自己的#cy#胃口#ec#和#cy#体形#ec#。\n\n
dialog_shara_boss1_prefight_4	嘿，污喙，你真的需要一个#cr#小姑娘#ec#来为你撑腰吗？她就是一只田鼠，别逗了！\n\n快#cr#滚#ec#，不然就准备挨揍吧！\n\n
dialog_shara_boss1_prefight_5	#cr#嘎！#ec#看到了吧，萨拉？！他们真的太坏了！\n\n
dialog_shara_boss1_prefight_6	没错。他们让我想起了我的族人和他们的#cr#无知#ec#。\n\n那时的我还不懂得如何为自己而战……\n\n
dialog_shara_boss1_prefight_7	但今天，我会很乐意#cg#“教育一下”#ec#这些蠢材。进攻！\n\n
dialog_shara_boss2_devicedestroyed_1	那个设备释放出的能量#cr#削弱了#ec#鬼灵！趁机解决他们！\n\n
dialog_shara_boss2_devicedestroyed_10	他根本不懂我。我在纷乱深渊里度过的每一天都充满着各种#cr#艰难的抉择#ec#。至少他帮了我一个忙，让所有人清晰明白一个#cy#非常简单#ec#的选择……\n\n
dialog_shara_boss2_devicedestroyed_11	要么跟随#cc#大姐头#ec#，帮忙拯救世界，要么就落得跟#cr#他#ec#一样的下场。\n\n
dialog_shara_boss2_devicedestroyed_2	我打败了你，但那设备还在。你永远配不上原能的力量，无论你调整多少次也不会改变这个事实。\n\n
dialog_shara_boss2_devicedestroyed_3	你太自以为是了……那个设备……它会和我一起死去。你很强，但你太青涩，而且缺少目标。如果你想要找到#cy#目标#ec#的话，你需要真正理解纷乱深渊的本质，你需要靠自己寻找目标。\n\n但你不会这么做……你做不到。#cr#你缺乏做出艰难抉择的能力#ec#。你甚至想象不到纷乱深渊的怒火。#cg#他#ec#会打败你……#cg#他#ec#……\n\n
dialog_shara_boss2_devicedestroyed_4	你的力量都来自于那个设备，英格索尔。我原以为你是另外一位#cc#原能#ec#大师，但看看你自己。\n\n你不配使用原能力量，你从未有过这种资格。\n\n
dialog_shara_boss2_devicedestroyed_5	没有目标的力量……毫无意义。你今天是赢了，但远在你明白纷乱深渊的真理之前，就会#cy#彻底陷入绝境#ec#。\n\n暴力很简单，但#cr#你缺乏做出艰难抉择的能力#ec#。你甚至想象不到纷乱深渊的怒火。#cg#他#ec#会打败你……#cg#他#ec#……\n\n
dialog_shara_boss2_devicedestroyed_6	#cy#她？！#ec#谁？英格索尔你……噢#cr#你竟敢#ec#对我做出这种事情！\n\n
dialog_shara_boss2_devicedestroyed_7	宁可摧毁这份技术也不愿意看到它流传于世。真是太自私了。只是……\n\n
dialog_shara_boss2_devicedestroyed_8	这个设备也被毁了。全都是英格索尔的错，他实在是太过目光短浅了。虽然如此……\n\n
dialog_shara_boss2_devicedestroyed_9	这种设备应该#cy#不止#ec#有一台。这并不是他自己发明的设备，他只是#cy#发现#ec#了这台设备。也就是说，我可以找到更多类似的设备。而且，我不像他，我不会#cy#浪费#ec#我所找到的力量。\n\n
dialog_shara_boss3victory_part1_1	#cr#关键系统错误 - 即将关闭#ec#\n\n#cy#正向#ec##cg#管理员#ec#发送通知\n\n
dialog_shara_boss3victory_part1_10	但首先……\n\n这个魔法盔甲后面藏了什么好宝贝？\n\n
dialog_shara_boss3victory_part1_11	有原能导管……小型水晶……唔\n\n这能量……好像有点扭曲。真奇怪。\n\n不管怎样……\n\n
dialog_shara_boss3victory_part1_12	如果这个#cg#管理员#ec#可以利用它来控制这台金属机器，我应该能够利用它来控制#cy#其他机器#ec#，让它们为#cr#我#ec#所用。\n\n
dialog_shara_boss3victory_part1_13	哔哔……\n\n啪哔噼啦？\n\n
dialog_shara_boss3victory_part1_14	啪砰？……\n\n啪哔噼啪砰！\n\n砰砰？\n\n
dialog_shara_boss3victory_part1_15	就是这样，带触手的小金属鸟。\n\n我是你新的铁哥们。\n\n
dialog_shara_boss3victory_part1_16	太完美了。\n\n
dialog_shara_boss3victory_part1_2	#cg#管理员#ec#？谁是你的“管理员”？你听命于什么人？！\n\n
dialog_shara_boss3victory_part1_3	#cg#启用管理员重写程序#ec#\n\n#cr#自毁已启动……#ec#
dialog_shara_boss3victory_part1_4	停！#cr#不！#ec#\n\n
dialog_shara_boss3victory_part1_5	这个#cg#管理员#ec#宁愿摧毁自己的发明，也不愿意让它落入我手中。简直和英格索尔如出一辙。\n\n我终于明白他的意思了。竟然有人愿意做出这程度的牺牲……这是何等强大的力量。\n\n
dialog_shara_boss3victory_part1_6	#cy#确实#ec#强大无比！这四周都是金属魔法。蕴藏着智慧和生命的机器？从虚无中创造的物质？\n\n这简直是#cg#神一般#ec#的力量。\n\n
dialog_shara_boss3victory_part1_7	这就是我的#cc#使命#ec#。\n\n
dialog_shara_boss3victory_part1_8	#cg#纷乱深渊#ec#里的其他人仍然活在愚昧的黑暗之中。他们就是一些摆弄石头和树枝的傻子，祈求树木以图获得丰收，在树林里狩猎野兽。\n\n这种情况该结束了。\n\n#cr#我的#ec#力量将为这个时代画上句号，并为我们开展崭新的未来。\n\n
dialog_shara_boss3victory_part1_9	这一切都始于，也将终于这个#cg#管理员#ec#。他藏有这些能改变世界的力量多久了？\n\n#cy#他#ec#就是我注定要解决的问题。我#cy#这一生都在等待#ec#这一刻，等待一切变得如此清晰。现在我必须完成后面的故事。\n\n
dialog_shara_boss4intro_1	#cr#停止。#ec#\n\nSHARA_LIFEFORM。存在计算错误。你是SHARA_AVATAR。停止所有破坏，开始维修。\n\n
dialog_shara_boss4intro_10	虚拟人像……\n\n你处理此信息时出现错误。\n\n
dialog_shara_boss4intro_11	我已掌握所有的信息。五万两千年……现在我终于真正认清了现实。\n\n当你那宝贵的#cg#管理员#ec#命令你自毁时，#cr#记得提醒他下一个就轮到他自己！#ec#\n\n
dialog_shara_boss4intro_2	哈！我不会再上当了，你们这些机器人休想再耍花招。不要再耍什么把戏，#cg#管理员#ec#！\n\n
dialog_shara_boss4intro_3	SHARA_AVATAR发生错误。#cg#管理员#ec#身处不同的设施。\n\n虚拟人像，受委任进行#cy#维修协助#ec#。\n\n必须遵守#cg#管理员#ec#生长计划。\n\n
dialog_shara_boss4intro_4	生长计划？他还有更多远大的计划，想要让我们们继续身陷泥泞和黑暗吗？行行好吧，把这些武器瞄准别的地方，告诉我#cg#管理员#ec#的位置。\n\n
dialog_shara_boss4intro_5	#cg#管理员#ec#已损坏。马上开始维修。\n\n上一次执行维护日期为#cy#52000年前#ec#。\n\n
dialog_shara_boss4intro_6	#cy#五万两千#ec#……？！这……怎么可能？\n\n即便是在最古老、最罕见的文字记载里，我都从未读到过这样久远的历史内容！\n\n难道我们真的被困在#cg#管理员#ec#所设的囚笼里这么久吗？\n\n
dialog_shara_boss4intro_7	成千上万年以来，难道就#cy#没有一个人#ec#有能力挑战#cg#管理员#ec#？一个人都没有？我们怎么都这么软弱？！\n\n
dialog_shara_boss4intro_8	若不进行维修，#cg#管理员#ec#即将发生故障。\n\n#cy#STRUCTURE_TANGLEDEEP#ec#的稳定性将受影响。\n\n#cy#STRUCTURE_TANGLEDEEP#ec#将发生级联故障。\n\n
dialog_shara_boss4intro_9	你们究竟#cr#丧心病狂#ec#到什么程度？\n\n你自私的主人为了确保我们#cr#永远找不到隐藏的技术#ec#，而创造了这个迷宫。现在，他宁可牺牲#cr#整片#ec#纷乱深渊也要阻止我发现这一切？\n\n
dialog_shara_boss4victory_1	你听见了吗，#cg#管理员#ec#？！\n\n你明白自己将面对怎样的下场了吗？！\n\n#cr#我们再也不会当你的囚犯了！#ec#\n\n
dialog_shara_boss4victory_10	干得好，污喙。我会送你一把我自己挖到的强力武器作为奖励，但一定要#cy#阅读使用说明#ec#。\n\n撤回到#cy#总部#ec#去，我要去找这个女人。我相信她和我会有不少事情要讨论。\n\n
dialog_shara_boss4victory_11	#cy#阅读使用说明#ec#……糟了……#cr#（嘎）#ec#\n\n
dialog_shara_boss4victory_2	#cy#（吱吱吱吱）#ec#额，#cc#大姐头#ec#？\n\n我有重要的事情要告诉你！\n\n
dialog_shara_boss4victory_3	#cy#污喙！#ec#\n\n又怎么……等等……\n\n你究竟是#cy#怎么#ec#到这里来的？\n\n
dialog_shara_boss4victory_4	#cy#嘎啊啊啊我#ec#跟着爆炸声和金属堆燃烧的痕迹就来到这里了。但，但是，#cc#大姐头#ec#，你必须听我说……\n\n
dialog_shara_boss4victory_5	一个#cg#非常非常厉害#ec#的家伙闯入了我们的老窝，还把我们都打了一顿！\n\n
dialog_shara_boss4victory_6	别告诉我又是那只#cy#从溪石来的胖浣熊#ec#和他的兄弟搞的鬼。\n\n
dialog_shara_boss4victory_7	不！怎么可能呢！……绝对不是他们！不，不，她看起来有点像你，#cc#大姐头#ec#。没有羽毛、毛皮、鳞片或是翅膀。她就连#cy#战斗#ec#方式和你如出一辙! 她很狡猾、很棘手，而且她也拥有#cy#力量#ec#。还有……还有……\n\n
dialog_shara_boss4victory_8	#cy#她侮辱了我的地毯！#ec#\n\n
dialog_shara_boss4victory_9	#cy#！！！#ec#\n\n#cy#那#ec#可真是出乎意料。一个像我一样的家伙，而且她还拥有足以打败你们的力量？这值得进一步观察。\n\n也许我可以说服这个#cg#神秘战士#ec#帮忙摧毁#cg#管理员#ec#。\n\n
dialog_shara_gamestart_scene_dream_02_text	修好……唯一……\n\n修理……
dialog_shara_gamestart_scene_dream_03_text	你的目标……你的力量……世界……\n\n……需要你……
dialog_shara_gamestart_scene_intro_01_text	纷乱深渊，我已经听到你的召唤很多年了，现在我已经准备好了。我已经不再是数年前被胆小鬼们抛弃在森林中那受到惊吓的小孩了。我已经能控制好我的力量了。今天，我会找到答案。
dialog_shara_gamestart_scene_intro_02_text	实现我使命的第一个挑战就是寻找追随我的人。建造一个更好的世界要从一个人开始，我发誓我一定会让追随我的人过上更好的生活。我知道纷乱深渊中还有很多我的盟友等着我，我能感受到他们。
dialog_shara_gamestart_scene_intro_text	我需要你
dialog_shara_intro_scene_intro_text	我再也见不到我的家人了。\n\n我……将独自一人。\n\n
dialog_shara_intro_scene_intro2_text	他们故意把我留在这……\n\n我从来没有故意伤害过任何人。\n\n
dialog_shara_intro_scene3_intro_text	有人吗？\n\n……我很害怕……\n\n
dialog_shara_intro_scene3_intro2_text	……其他人都去哪了？妈妈呢？爸爸呢？\n\n
dialog_shara_note_text	亲爱的#cy#萨拉#ec#，\n\n你告诉过我们很多次你有一些伟大的#cy#目标#ec#。你曾经无数次从恶梦中惊醒，大喊说我们在阻止你。\n\n很抱歉，我们当中没有一个人知道你的目标到底是什么，但我们也从没有阻止过你。\n\n纷乱深渊#cy#很危险#ec#，但你也一样。不要忘记，你比你所要面临的挑战都要强大。\n\n
dialog_shara_postboss4victory_robot_1	管理员。\n\n情况：未定义。\n\n当前危险水平——\n\n
dialog_shara_postboss4victory_robot_10	这不无可能，管理员女士。\n\n回顾过去的记录，似乎#cy#孵化仪49.1X#ec#孵化了#cy#两个#ec#虚拟人像。#cy#孵化仪49.1X#ec#并未提出相关报告。\n\n我将重新分配#cy#孵化仪49.1X#ec#，将其送往第3区，为“青蛙.生命体”进行废物处理工作。\n\n
dialog_shara_postboss4victory_robot_11	我们相信剩余的51%在#cy#第二个虚拟人像#ec#中。目前有一个#co#带来毁灭的载体#ec#，从溪石农场区为起点一路掠夺，直指我们所在位置。此行为有99.4%几率为另一个虚拟人像的作为。\n\n
dialog_shara_postboss4victory_robot_12	#cr#两个虚拟人像？#ec#据我所知，这应该不可能发生。若#cg#人类.繁殖#ec#湿件于未来进行任何升级，请立即通知我。\n\n无论如何，我们需要解决这个问题。开始#cr#分解#ec#虚拟人像，用所获材料组合成新的虚拟人像。\n\n
dialog_shara_postboss4victory_robot_13	此前我们对多个#cg#人类.数据点#ec#进行了#cy#多次#ec#重组尝试，却未能获得成功。\n\n
dialog_shara_postboss4victory_robot_14	不可接受。我们设计这些模型是有原因的。\n\n通过其独特的#cg#虚拟人像.生命力.原型#ec#所产生的#ca#谐波原能#ec#，是我们在其他任何地方所无法获得的。\n\n
dialog_shara_postboss4victory_robot_15	了解，管理员女士。请求允许对所有农场区#cr#重新格式化#ec#并重新开始。\n\n我们应可在最短#cy#五百零十二年#ec#内孵化一个新虚拟人像。\n\n
dialog_shara_postboss4victory_robot_16	不可接受。我不能再忍受#cy#其他管理员#ec#再次对我们进行乏味的分析。\n\n我们将允许两个虚拟人像见面，并观察其结果。我非常有信心，她们将掌握其使命的重要性，维修工作将在其后迅速完成。\n\n
dialog_shara_postboss4victory_robot_17	我认为情况不如您所想的那么乐观，主管女士。
dialog_shara_postboss4victory_robot_18	了解，但我不同意。\n\n一直以来，虚拟人像都为我们服务，她们的原能永远会为我们提供燃料。毕竟，那是她们的#cg#使命#ec#。我们会养育她们、引导她们，并保护她们不受#clr#外界#ec#的伤害。\n\n
dialog_shara_postboss4victory_robot_19	我在复制器52处为你分配额外资源。若再次犯错，我将#cr#不饶恕你#ec#。\n\n
dialog_shara_postboss4victory_robot_2	守护者单位。停止所有音频通信。\n\n切换到直接二进制传输方式。\n\n
dialog_shara_postboss4victory_robot_3	…\n\n……\n\n001010010010010111010101011…\n\n
dialog_shara_postboss4victory_robot_4	请原谅我，管理员女士。我不确定如何与#cy#萨拉.虚拟人像#ec#互动。她的成长模式大幅度偏离预设参数，她的行为完全不符合逻辑。\n\n
dialog_shara_postboss4victory_robot_5	请确认。#cg#迎宾单位#ec#在她到来时发生了故障？\n\n
dialog_shara_postboss4victory_robot_6	不完全是。扫描结果显示，她与维修虚拟人像DNA匹配结果为阴性，因#cy#萨拉.虚拟人像#ec#的格式与原型匹配度仅有49%。我查阅了战后数据——\n\n
dialog_shara_postboss4victory_robot_7	#cr#战斗！？#ec#请立即提供详细解释。\n\n
dialog_shara_postboss4victory_robot_8	是的，管理员女士。#cy#萨拉.虚拟人像#ec#在面对挑战时呈现暴力反应。\n\n这必定是由她DNA所包含的预测外数据所导致的。\n\n
dialog_shara_postboss4victory_robot_9	49%的DNA匹配度明确显示#cy#孵化仪#ec#单位已出现故障。\n\n
dialog_shara_preboss2_banditshelp_1	#cc#大姐头#ec#，我们是来帮忙的！我们不会让你独自战斗的，#cy#啾啾#ec#！\n\n
dialog_shara_preboss2_banditshelp_2	#cy#鸟人兄弟#ec#，挡下那些怪物！如果我能摧毁这个#cc#设备#ec#，我相信#cc#鬼灵#ec#的力量会被大大#cr#削弱#ec#。注意你们的背后！\n\n
dialog_shara_preboss2_fight_1	……只要再添加一点#cr#火焰#ec#和#cy#闪电#ec#……一点#cc#冰霜#ec#和#cr#暗影#ec#……\n\n我能感觉到#cc#原能#ec#正在凝聚……就是这样……\n\n……太好了！\n\n
dialog_shara_preboss2_fight_10	#cr#我加入你？#ec#长在你脑袋瓜上的那堆白色稻草使你看不清现实吗？\n\n也许你还没有清楚地意识到你的处境：是#cy#我#ec#在控制这台设备，是#cy#我#ec#在控制这些鬼灵，而#cr#你#ec#要是再说一句失礼的话，你就将成为我的下一堆数据！\n\n
dialog_shara_preboss2_fight_11	如果你所谓的“#cc#使命#ec#”指引你去“修复世界”，那么恭喜你，它引导你来到了正确的地方。这力量是#cy#变化的原始本质#ec#。它可以创造、毁灭、修复尚能被拯救的事物，并摧毁其他的一切。\n\n但这是#cy#我#ec#的力量。只有我在用它控制纷乱深渊里的所有古老技术后，我才会和你分享这股力量。\n\n然后，我们将创造一个尊#cy#我#ec#为无上统治者的世界，而#cc#你#ec#可以骄傲地伴随我左右。\n\n
dialog_shara_preboss2_fight_12	如果你打算用这种力量做那种无聊的事，那我别无选择。我只能阻止你。我会继续你的研究……\n\n
dialog_shara_preboss2_fight_13	……#cy#并占为己有#ec#，无人会记得你的名字。\n\n
dialog_shara_preboss2_fight_2	你，你在做什么？感觉就像……糟了！不好了！#cc#大姐头！#ec#救命啊啊啊！\n\n
dialog_shara_preboss2_fight_3	什么？！那种力量#cy#远远#ec#超过肉体所能承受的程度，你到底在想什么？！你真的明白自己在随意调动的是何种力量吗？\n\n
dialog_shara_preboss2_fight_4	终于来了一位大脑正常运作的客人。真是令人耳目一新。\n\n欢迎来到我的#cy#研究站#ec#，你可以称我为“#cy#英格索尔#ec#”。\n\n我是一名谦逊的#cc#原能#ec#学者，容我回答你无礼的问题：是的。我对原能的力量相当了解，而这台奇妙的设备便是我研究成果的前沿之作。\n\n
dialog_shara_preboss2_fight_5	你……你是#cy#故意#ec#这么做的？\n\n
dialog_shara_preboss2_fight_6	当然。只要能从实验中获得丰富的数据，#cr#烧焦几根羽毛#ec#又算得了什么。我愿意与你分享我的研究数据，我需要一名#cy#助理#ec#来帮忙组织和准备这些信息。\n\n
dialog_shara_preboss2_fight_7	#cr#我不会为任何人打下手#ec#，英格索尔！我也不会再让你动我的#cy#鸟人兄弟#ec#身上的一根羽毛！\n\n
dialog_shara_preboss2_fight_8	好吧，那我只好用那十几个强盗帮里那些无用的无名小卒。\n\n我知道#cg#纷乱深渊#ec#是怎么运作的。你能走到这里来，手也不可能没弄脏。\n\n
dialog_shara_preboss2_fight_9	你说得没错。我有一个#cc#使命#ec#，没有人能阻止我修复这个破碎的世界。我会尽我所能，但这并不代表你不能发挥你的作用。如果你加入我……\n\n
dialog_shara_preboss2_passage_1	#cc#大姐头#ec#！女士，请您帮帮我们！楼上房间里有个家伙#cy#彻底地疯了#ec#！!\n\n他有一种奇怪的魔法……\n\n
dialog_shara_preboss2_passage_2	等等，你刚才叫我什么？\n\n
dialog_shara_preboss2_passage_3	呃……#cc#大姐头#ec#，因为您是老大嘛？而且还是位淑女！听着，女士，如果你能帮我们对付那只能凭空召唤可怕生物的疯鸟，您让我怎么称呼您都行！\n\n
dialog_shara_preboss2_passage_4	（#cy#召唤#ec#生物？难道他拥有和我一样的力量？是命中注定要完成这项使命的一个盟友吗？\n\n#cg#纷乱深渊#ec#的秘密正一个接一个地被揭开，正如我所希望的一样！还有什么可以……）\n\n
dialog_shara_preboss2_passage_5	呃，#cc#大姐头#ec#？喂喂？您还在吗？\n\n
dialog_shara_preboss2_passage_6	哦！在，还在。谢谢你，勇敢的兄弟，你做得很好。向公爵报告这件事，我会前往调查的。\n\n
dialog_shara_preboss3_part1_1	这真是个不可思议的地方！周围的#cc#原能#ec#感觉如此……纯净。我没想到纷乱深渊的中心地带会有这么多金属制品，这#cy#肯定#ec#是英格索尔那台设备的来源地。\n\n
dialog_shara_preboss3_part1_10	#cy#说出你的目的。#ec#\n\n
dialog_shara_preboss3_part1_11	#cc#目的！？#ec#\n\n
dialog_shara_preboss3_part1_12	我的#cc#目的#ec#很明确。自我记事以来，我便一直受到召唤，叫我前来这个地方，用我的#cy#力量#ec#来修复这个世界！\n\n
dialog_shara_preboss3_part1_13	#cy#SHARA_LIFEFORM，目的：召唤至装配厂进行维修。你正在接受评估。请保持静止#ec#\n\n
dialog_shara_preboss3_part1_14	#cy#…\n\n……\n\n………#ec#\n\n
dialog_shara_preboss3_part1_15	#cy#SHARA_LIFEFORM与维修虚拟人像匹配度：#cr#49%#cy#\n\n你的目的遭拒绝。\n\n#cr#马上离开装配设施库。#ec#\n\n
dialog_shara_preboss3_part1_16	自我记事以来，我的使命就是要到这个地方来，而你竟然告诉我，我“遭拒绝”了？\n\n#cr#你好意思吗！#ec#\n\n
dialog_shara_preboss3_part1_17	我们做个交易吧。我了解到不少有关下方森林的知识。我很乐意与你分享我的发现，只要你愿意告诉我更多关于#cy#技术#ec#……\n\n
dialog_shara_preboss3_part1_18	#cr#SHARA_LIFEFORM。#ec#\n\n#cy#马上离开装配设施库，#ec##cr#否则你会被移除。\n\n#cr#这是你最后的警告。#ec#\n\n
dialog_shara_preboss3_part1_19	我#cr#绝不#ec#离开！\n\n在达成我的#cc#使命#ec#之前，我决不妥协！这个世界支离破碎，居住其中的人民生活在黑暗和无知之中。只要使用你所#cy#隐藏#ec#的技术，我就可以纠正这一切！\n\n那台可以凭空制造出物质的机器，可以结束所有因资源短缺而造成的#cy#困苦#ec#和#cy#冲突#ec#，还有……\n\n
dialog_shara_preboss3_part1_2	终于找到了！和#cy#英格索尔#ec#使用的那台设备一样，#cc#原能#ec#在这台设备里奔流着，但是到底是谁在控制它呢？\n\n等等，#cy#能量#ec#正在凝聚！\n\n
dialog_shara_preboss3_part1_20	#cr#SHARA_LIFEFORM。准备永久停机和拆卸。#ec#\n\n
dialog_shara_preboss3_part1_21	#cr#你、阻、止、不、了、我！#ec#\n\n
dialog_shara_preboss3_part1_3	什么……我刚才看到什么了？\n\n
dialog_shara_preboss3_part1_4	这台设备刚刚是不是凭空创造了#cy#物质#ec#？那不是……它#cy#应该#ec#不能……\n\n我必须#cy#马上#ec#找控制这一切的人好好谈谈。\n\n
dialog_shara_preboss3_part1_5	#cr#入侵者。入侵者。#ec#\n\n#cy#停下。不许再前进。说出你的名字#ec#\n\n
dialog_shara_preboss3_part1_6	这些魔法盔甲会#cy#说话#ec#？\n\n
dialog_shara_preboss3_part1_7	难道……有人在里面？那他们肯定很小只……\n\n
dialog_shara_preboss3_part1_8	#cr#说出你的名字。#ec#\n\n
dialog_shara_preboss3_part1_9	好吧，好吧。\n\n你好，会说话的盔甲。我叫萨拉。很高兴认识你？\n\n
dialog_waypoint_unlocked_text_shara	#big##cg#已解锁传送点！#ec##endbig#\n\n你现在可以从安全的#cc#萨拉营地#ec##cy#快速旅行#ec#至#cy#^$getstring:fasttravel_destination$^#ec#。\n\n你也可以在安全的边缘区域使用你的^tag5^。\n\n
exp_armormaster_statue_name	护甲大师的雕像
exp_armormaster_statue_text	这是一个精通所有护甲和护盾的#cy#强大守护者#ec#的雕像。\n\n这里有一个仁善的光环弥漫着#cc#原能#ec#，好像他想把#cg#他知识的碎片#ec#传授给我。\n\n我应该在这里冥想吗？\n
exp_bomb_minibombs_desc	这些小玩意是多么的可爱，我真不舍得把它们扔出去……
exp_bomb_minibombs_effectdesc	在一个小范围内造成一个小型爆炸攻击，造成当前生命^number1^的物理伤害
exp_bomb_minibombs_name	袖珍炸弹
exp_bomb_oildrum_desc	我确定一旦我找到一个合适的未知倒油出来，效果将会非常好。
exp_bomb_oildrum_effectdesc	创造一滩持续^number1^回合的浮油。油中的怪物每回合受到^number1^毒属性伤害，火属性攻击会点燃它（每回合^number3^伤害）
exp_bomb_oildrum_name	油桶
exp_campaign_select_info_mirai	米莱受与生俱来的好奇心驱使。她在溪石营地展开旅途，并在那里遇到形形色色的人。她将深入纷乱深渊，试图揭露深藏其中的秘密。\n\n感受《纷乱深渊》的核心故事，#cc#适合所有玩家，无需担心操作熟练度。#ec#赚取经验来提升等级，还可获取职业点数来学习各种独特职业的技能。
exp_campaign_select_info_shara	萨拉的心中有一个不平凡的远大目的。她小时候被人遗弃在纷乱深渊的荒野之中，而现在她下定决心，要亲自创造属于自己的未来。\n\n#cr#极具挑战性的冒险#ec#，专为《纷乱深渊》的资深玩家而设！花费职业点数来提升属性，并通过特殊宝箱和活动，从海量#cc#随机#ec#技能中学习。
exp_campaign_select_label_mirai	米莱的故事
exp_campaign_select_label_shara	萨拉的故事
exp_campaign_select_title	<size=60>#cy#你会选择哪一段旅途呢？#ec#</size>\n\n“纷乱深渊呼唤着我，它所深藏的秘密可能会改变世界……”
exp_choose_shara_ability_text	#big##cc#获得新能力#ec##endbig#\n\n你对知识的不懈探索让你解锁了一个新的#cc#能力#ec#。谨慎地选择一个...错过的选项可能永远也看不到了！\n
exp_choose_shara_ability_unique_text	每天我都感觉离目标更近了一步。我对#cc#原能#ec#的掌握更精湛了……\n
exp_damage_down	伤害下降！
exp_dialog_learnskill_fromitem_text	充满能量的石头嗡嗡作响，你感觉自己几乎就要成功发掘被遗忘已久的知识。只要足够专注，你就可以揭示其中的奥秘。
exp_dialog_unlocksharamode_txt	<size=50><color=#40b843>恭喜！</color></size>\n\n你解锁了#cc#萨拉的故事#ec#。这是#cg#纷乱深渊#ec#中单独的冒险，拥有新的故事和独特的玩法。\n\n从现在开始，当你在#cy#任何存档栏#ec#开始新角色时，可以选择这个新战役。\n\n
exp_dualwielder_bonus1	降低双持武器（任意类型）的伤害惩罚。提升迅捷、精神和戒律。
exp_dualwielder_bonus2	你所召唤的卷轴持续时间加倍。
exp_dualwielder_bonus3	卷轴和舞文弄墨对临近敌人造成的伤害+25%。
exp_dualwielder_jobdesc	这位双持武器专家是刀与笔方面的大师。虽然防御较低，但能释放强大的连击技和元素攻击。
exp_energyshield_add	一面#cc#能量护盾#ec#环绕着#cy#^tag1^#ec#！
exp_fisherman_name	神秘流浪者
exp_item_gem8_name	白金
exp_item_gem9_name	钻石
exp_item_runeofknowledge	知识符文
exp_item_runeofknowledge_extradesc	我能感觉到这块石头中刻印着真正的智慧！如果我能充分利用自己所学到的知识来破解这个符文，最后一定会能大有所获。
exp_item_runeofknowledge0_desc	我能感觉到这块石头中刻印着真正的智慧！如果我能充分利用自己所学到的知识来破解这个符文，最后一定会能大有所获。
exp_item_runeofknowledge1_desc	我能感觉到这块石头中刻印着真正的智慧！如果我能充分利用自己所学到的知识来破解这个符文，最后一定会能大有所获。
exp_item_runeofknowledge2_desc	我能感觉到这块石头中刻印着真正的智慧！如果我能充分利用自己所学到的知识来破解这个符文，最后一定会能大有所获。
exp_item_runeofknowledge3_desc	我能感觉到这块石头中刻印着真正的智慧！如果我能充分利用自己所学到的知识来破解这个符文，最后一定会能大有所获。
exp_item_runeofknowledge4_desc	我能感觉到这块石头中刻印着真正的智慧！如果我能充分利用自己所学到的知识来破解这个符文，最后一定会能大有所获。
exp_item_runeofknowledge5_desc	我能感觉到这块石头中刻印着真正的智慧！如果我能充分利用自己所学到的知识来破解这个符文，最后一定会能大有所获。
exp_item_runeofknowledge6_desc	我能感觉到这块石头中刻印着真正的智慧！如果我能充分利用自己所学到的知识来破解这个符文，最后一定会能大有所获。
exp_item_runeofknowledge7_desc	我能感觉到这块石头中刻印着真正的智慧！如果我能充分利用自己所学到的知识来破解这个符文，最后一定会能大有所获。
exp_item_runeofknowledge8_desc	我能感觉到这块石头中刻印着真正的智慧！如果我能充分利用自己所学到的知识来破解这个符文，最后一定会能大有所获。
exp_item_runeofknowledge9_desc	教会一项新#cy#技能#ec#，消耗^number1^职业点数。
exp_item_sharaorb_desc	萨拉走了。我只希望我们能够一起成长；如果她知道我们相遇前我的经历，这一切可能都会不一样吧。拿着这个球，我能感受到在她的生命中野心和绝望一直在驱使着她。我希望我有一天能理解她，我要带着这个去梦境仪！
exp_item_sharaorb_name	萨拉的幻想之球
exp_item_weapon0_name	锈迹斑斑的剑
exp_job_dualwielder	书法家
exp_job_SORCERESS_desc1	你#cr#不能获得经验#ec#。作为替代，你可以用职业点数提升状态。你可以在#cy#潘多拉魔盒s#ec#里找到新技能并学习。
exp_job_SORCERESS_jobdesc	寻找救赎…
exp_jobname_sorceress	女巫
exp_leg_accessoryname1	珠宝
exp_leg_accessoryname10	奇珍
exp_leg_accessoryname11	护身符
exp_leg_accessoryname12	传家宝
exp_leg_accessoryname13	秘藏
exp_leg_accessoryname14	奖励
exp_leg_accessoryname15	凡品
exp_leg_accessoryname16	小玩意
exp_leg_accessoryname17	恩典
exp_leg_accessoryname18	华丽
exp_leg_accessoryname19	幸运
exp_leg_accessoryname2	饰品
exp_leg_accessoryname20	雄伟
exp_leg_accessoryname21	信物
exp_leg_accessoryname3	宝石
exp_leg_accessoryname4	装饰
exp_leg_accessoryname5	纪念
exp_leg_accessoryname6	杰作
exp_leg_accessoryname7	灵符
exp_leg_accessoryname8	奇幻
exp_leg_accessoryname9	奇异
exp_leg_accessorypropername1	阿吉马特
exp_leg_accessorypropername10	翁法洛斯
exp_leg_accessorypropername2	护身宝符
exp_leg_accessorypropername3	山猫石
exp_leg_accessorypropername4	如意宝珠
exp_leg_accessorypropername5	圣石
exp_leg_accessorypropername6	尼迪
exp_leg_accessorypropername7	伊利阿斯特尔
exp_leg_accessorypropername8	阿索斯
exp_leg_accessorypropername9	魔石
exp_leg_armorpropername1	卡瓦恰
exp_leg_armorpropername10	泰坦
exp_leg_armorpropername11	艾德曼合金
exp_leg_armorpropername12	卡尔马尼奥拉
exp_leg_armorpropername13	哈迪斯
exp_leg_armorpropername14	平家
exp_leg_armorpropername2	赫菲斯托斯
exp_leg_armorpropername3	源氏
exp_leg_armorpropername4	麦斯米伦
exp_leg_armorpropername5	军械
exp_leg_armorpropername6	密涅瓦
exp_leg_armorpropername7	提亚玛特
exp_leg_armorpropername8	尼普顿
exp_leg_armorpropername9	朱庇特
exp_leg_axename1	之斧
exp_leg_axename2	切割刃
exp_leg_axename3	劈斧
exp_leg_axename4	短斧
exp_leg_axename5	斩骨斧
exp_leg_axepropername1	双刃斧
exp_leg_axepropername2	双手劈斧
exp_leg_axepropername3	乌弗海登
exp_leg_axepropername4	狂暴
exp_leg_axepropername5	宙斯
exp_leg_axepropername6	阿瑞斯
exp_leg_axepropername7	巨人
exp_leg_bookpropername1	托特
exp_leg_bookpropername10	马萨布尔之书
exp_leg_bookpropername11	多尔甘那斯·伊阿乌
exp_leg_bookpropername12	帕尔马·库鲁伊娜
exp_leg_bookpropername13	矮人之书
exp_leg_bookpropername2	预言者
exp_leg_bookpropername3	纳欧斯基拉
exp_leg_bookpropername4	命运
exp_leg_bookpropername5	奥德赛
exp_leg_bookpropername6	银河
exp_leg_bookpropername7	第五要素
exp_leg_bookpropername8	魔能
exp_leg_bookpropername9	梅林
exp_leg_clawname1	之爪
exp_leg_clawname2	之拳
exp_leg_clawname3	指虎
exp_leg_clawname4	剪刀
exp_leg_clawname5	巨掌
exp_leg_clawname6	利爪
exp_leg_clawpropername1	神之手
exp_leg_clawpropername2	超灵
exp_leg_clawpropername3	壮志
exp_leg_clawpropername4	好战者
exp_leg_clawpropername5	乾坤圈
exp_leg_clawpropername6	乌鲁斯拉格纳
exp_leg_clawpropername7	斯法莱
exp_leg_daggername1	长钉
exp_leg_daggername2	刺叉
exp_leg_daggername3	火钳
exp_leg_daggername4	刺骨刀
exp_leg_daggername5	獠牙
exp_leg_daggername6	倒钩
exp_leg_daggername7	波刃剑
exp_leg_daggername8	匕首
exp_leg_daggername9	小刀
exp_leg_daggerpropername1	卡尔温南
exp_leg_daggerpropername2	水星
exp_leg_daggerpropername3	芬里厄
exp_leg_daggerpropername4	团右卫门
exp_leg_daggerpropername5	拳刃
exp_leg_daggerpropername6	阿修罗
exp_leg_daggerpropername7	午夜
exp_leg_defensename1	保体
exp_leg_defensename10	护套
exp_leg_defensename11	防御
exp_leg_defensename12	守护者
exp_leg_defensename13	捍卫者
exp_leg_defensename14	驻防
exp_leg_defensename15	棱堡
exp_leg_defensename16	城塞
exp_leg_defensename17	城堡
exp_leg_defensename2	守卫
exp_leg_defensename3	神盾
exp_leg_defensename4	堡垒
exp_leg_defensename5	铁壁
exp_leg_defensename6	要塞
exp_leg_defensename7	铜墙
exp_leg_defensename8	保卫
exp_leg_defensename9	避难所
exp_leg_generaldescriptorname1	天国
exp_leg_generaldescriptorname10	神圣
exp_leg_generaldescriptorname11	神秘
exp_leg_generaldescriptorname12	不屈
exp_leg_generaldescriptorname13	万能
exp_leg_generaldescriptorname14	无敌
exp_leg_generaldescriptorname15	不灭
exp_leg_generaldescriptorname16	无尽
exp_leg_generaldescriptorname17	史诗
exp_leg_generaldescriptorname18	英雄
exp_leg_generaldescriptorname19	荣誉
exp_leg_generaldescriptorname2	永恒
exp_leg_generaldescriptorname20	精致
exp_leg_generaldescriptorname21	孤独
exp_leg_generaldescriptorname22	孤寂
exp_leg_generaldescriptorname23	巨大
exp_leg_generaldescriptorname24	绵延
exp_leg_generaldescriptorname25	恐怖
exp_leg_generaldescriptorname26	巨型
exp_leg_generaldescriptorname27	坚定
exp_leg_generaldescriptorname28	难忘
exp_leg_generaldescriptorname29	高深
exp_leg_generaldescriptorname3	光辉
exp_leg_generaldescriptorname30	隐秘
exp_leg_generaldescriptorname31	高深莫测
exp_leg_generaldescriptorname4	无限
exp_leg_generaldescriptorname5	圣洁
exp_leg_generaldescriptorname6	地狱
exp_leg_generaldescriptorname7	永生
exp_leg_generaldescriptorname8	至高
exp_leg_generaldescriptorname9	超凡
exp_leg_genericobjectname1	古物
exp_leg_genericobjectname10	噩梦
exp_leg_genericobjectname11	馈赠
exp_leg_genericobjectname12	传奇
exp_leg_genericobjectname13	旅者
exp_leg_genericobjectname14	命运
exp_leg_genericobjectname15	神秘
exp_leg_genericobjectname16	誓约
exp_leg_genericobjectname17	呼唤
exp_leg_genericobjectname18	精髓
exp_leg_genericobjectname19	决心
exp_leg_genericobjectname2	圣物
exp_leg_genericobjectname20	指令
exp_leg_genericobjectname3	战利品
exp_leg_genericobjectname4	荣誉
exp_leg_genericobjectname5	赐物
exp_leg_genericobjectname6	迷物
exp_leg_genericobjectname7	纪念碑
exp_leg_genericobjectname8	凯旋
exp_leg_genericobjectname9	回忆
exp_leg_genericweaponname1	武备
exp_leg_genericweaponname10	争斗
exp_leg_genericweaponname11	正义
exp_leg_genericweaponname12	裁决者
exp_leg_genericweaponname13	毁灭
exp_leg_genericweaponname14	暴虐
exp_leg_genericweaponname15	嘈杂
exp_leg_genericweaponname2	强袭
exp_leg_genericweaponname3	纷争
exp_leg_genericweaponname4	战争
exp_leg_genericweaponname5	猛袭
exp_leg_genericweaponname6	游击
exp_leg_genericweaponname7	反目
exp_leg_genericweaponname8	哀伤
exp_leg_genericweaponname9	苦难
exp_leg_glovename1	手套
exp_leg_glovename2	护手
exp_leg_glovename3	手铠
exp_leg_glovename4	拳击手套
exp_leg_glovename5	护腕
exp_leg_hammername1	打击之锤
exp_leg_hammername2	碾压之锤
exp_leg_hammername3	冲击之锤
exp_leg_hammername4	锤
exp_leg_hammername5	权杖
exp_leg_hammername6	重击之锤
exp_leg_hammername7	大锤
exp_leg_hammername8	驱动之锤
exp_leg_hammername9	小槌
exp_leg_hammerpropername1	雷神之鎚
exp_leg_hammerpropername2	天雷神斧
exp_leg_hammerpropername3	沙鲁尔
exp_leg_hammerpropername4	放逐
exp_leg_hammerpropername5	驱逐
exp_leg_hammerpropername6	赫拉克勒斯
exp_leg_hammerpropername7	主宰
exp_leg_heavyarmorname1	护甲
exp_leg_heavyarmorname2	板甲
exp_leg_heavyarmorname3	骑士袍
exp_leg_heavyarmorname4	护身锁甲
exp_leg_helmetname1	头盔
exp_leg_helmetname2	头铠
exp_leg_helmetname3	便帽
exp_leg_helmetname4	帽子
exp_leg_helmetname5	王冠
exp_leg_helmetname6	头具
exp_leg_helmetpropername1	塔因头盔
exp_leg_helmetpropername2	歌丝薇特
exp_leg_historicname1	亚雷斯坦
exp_leg_historicname10	编织者
exp_leg_historicname100	雅扎让
exp_leg_historicname101	博迪旺
exp_leg_historicname11	希勒布兰德
exp_leg_historicname12	米凯尔森
exp_leg_historicname13	毛屁孩
exp_leg_historicname14	乌纳兹
exp_leg_historicname15	阿克瑟罕
exp_leg_historicname16	齐塞多
exp_leg_historicname17	奥尔德温
exp_leg_historicname18	克雷纳克
exp_leg_historicname19	沃丁格
exp_leg_historicname2	野火女士
exp_leg_historicname20	迪斯东
exp_leg_historicname21	帕塔舒
exp_leg_historicname22	阿沙巴
exp_leg_historicname23	精粹
exp_leg_historicname24	奥谢拉克
exp_leg_historicname25	奥菲安
exp_leg_historicname26	布罗加
exp_leg_historicname27	佐克
exp_leg_historicname28	赫科雷克
exp_leg_historicname29	阿瓦林
exp_leg_historicname3	巴迪克
exp_leg_historicname30	赛夫兰
exp_leg_historicname31	吉罗苏
exp_leg_historicname32	阿罗文
exp_leg_historicname33	亚歌德
exp_leg_historicname34	文基
exp_leg_historicname35	迪安舍
exp_leg_historicname36	阿古斯
exp_leg_historicname37	卡莱琳娜
exp_leg_historicname38	乌玛缇拉
exp_leg_historicname39	穆肯因
exp_leg_historicname4	杰莫
exp_leg_historicname40	今野
exp_leg_historicname41	泰洛安
exp_leg_historicname42	维多
exp_leg_historicname43	阿兰多
exp_leg_historicname44	布劳德
exp_leg_historicname45	杜莎
exp_leg_historicname46	葛罗恩
exp_leg_historicname47	尔斯科普
exp_leg_historicname48	毛罗格
exp_leg_historicname49	谢普德
exp_leg_historicname5	赞达兹
exp_leg_historicname50	寇玛坎
exp_leg_historicname51	希尔通
exp_leg_historicname52	塔瑟瑞丝
exp_leg_historicname53	多诺凡
exp_leg_historicname54	贾莫斯
exp_leg_historicname55	贾克
exp_leg_historicname56	马哈雷
exp_leg_historicname57	库杰
exp_leg_historicname58	莫鲁克
exp_leg_historicname59	艾德里安
exp_leg_historicname6	达娜
exp_leg_historicname60	安特
exp_leg_historicname61	萨那
exp_leg_historicname62	兔子
exp_leg_historicname63	纳阿
exp_leg_historicname64	海布瑞思
exp_leg_historicname65	帕克拉托斯
exp_leg_historicname66	巴尔布莱尔
exp_leg_historicname67	扎格隆
exp_leg_historicname68	泽雷斯
exp_leg_historicname69	阿努宾斯
exp_leg_historicname7	哨哨
exp_leg_historicname70	菲尼克斯
exp_leg_historicname71	哈斯拉克丝
exp_leg_historicname72	阿尔达罗克
exp_leg_historicname73	巴拉姆
exp_leg_historicname74	帕维尔
exp_leg_historicname75	迪斯丹
exp_leg_historicname76	摩甘
exp_leg_historicname77	铁木沁
exp_leg_historicname78	荣科特斯
exp_leg_historicname79	赫尔绍
exp_leg_historicname8	兰斯
exp_leg_historicname80	埃伦塔兰
exp_leg_historicname81	鲁坦
exp_leg_historicname82	马哈库
exp_leg_historicname83	弗里坎德尔
exp_leg_historicname84	达拉哈利安
exp_leg_historicname85	班莫
exp_leg_historicname86	塔姆里克
exp_leg_historicname87	克莱格米尔
exp_leg_historicname88	泽巴
exp_leg_historicname89	流体
exp_leg_historicname9	里多基洛斯
exp_leg_historicname90	特尔杜恩
exp_leg_historicname91	凯维尔
exp_leg_historicname92	德拉库纳斯
exp_leg_historicname93	墨库莱斯
exp_leg_historicname94	忒尔拉
exp_leg_historicname95	阿塔兰
exp_leg_historicname96	托泽兰
exp_leg_historicname97	法
exp_leg_historicname98	科里亚布
exp_leg_historicname99	纳迪阿斯
exp_leg_instrumentname1	乐曲
exp_leg_instrumentname2	梦幻
exp_leg_instrumentname3	頌歌
exp_leg_instrumentname4	咏叹调
exp_leg_instrumentname5	民谣
exp_leg_instrumentname6	颂歌
exp_leg_instrumentname7	赞美诗
exp_leg_instrumentname8	交响曲
exp_leg_lightarmorname1	长袍
exp_leg_lightarmorname2	长袍
exp_leg_lightarmorname3	衬衫
exp_leg_lightarmorname4	斗篷
exp_leg_lightarmorname5	系带外套
exp_leg_lightarmorname6	外衣
exp_leg_lightarmorname7	装束
exp_leg_magicbookname1	之书
exp_leg_magicbookname2	之卷
exp_leg_magicbookname3	秘典
exp_leg_magicbookname4	图册
exp_leg_magicbookname5	法典
exp_leg_magicbookname6	词典
exp_leg_magicbookname7	魔典
exp_leg_magicbookname8	编年史
exp_leg_magicbookname9	记录
exp_leg_magicname1	法术
exp_leg_magicname2	预言
exp_leg_magicname3	咒语
exp_leg_magicname4	光环
exp_leg_magicname5	诅咒
exp_leg_magicname6	魔法
exp_leg_magicname7	灵符
exp_leg_magicname8	厄咒
exp_leg_magicname9	巫术
exp_leg_mediumarmorname1	锁甲
exp_leg_mediumarmorname2	马甲
exp_leg_mediumarmorname3	夹克
exp_leg_mediumarmorname4	外套
exp_leg_mediumarmorname5	甲胄
exp_leg_mediumarmorname6	革胄
exp_leg_necklacename1	护身符
exp_leg_necklacename2	项链
exp_leg_necklacename3	项圈
exp_leg_necklacename4	项坠
exp_leg_necklacename5	护身符
exp_leg_necklacename6	胸针
exp_leg_personaldescriptorname1	珍爱
exp_leg_personaldescriptorname10	钟爱
exp_leg_personaldescriptorname11	失窃
exp_leg_personaldescriptorname12	挚爱
exp_leg_personaldescriptorname13	遗落
exp_leg_personaldescriptorname14	隐藏
exp_leg_personaldescriptorname15	遗弃
exp_leg_personaldescriptorname16	无价
exp_leg_personaldescriptorname17	绝妙
exp_leg_personaldescriptorname2	宝贵
exp_leg_personaldescriptorname3	传说
exp_leg_personaldescriptorname4	遗忘
exp_leg_personaldescriptorname5	迷失
exp_leg_personaldescriptorname6	著名
exp_leg_personaldescriptorname7	高尚
exp_leg_personaldescriptorname8	荣誉
exp_leg_personaldescriptorname9	可靠
exp_leg_quivername1	箭袋
exp_leg_quivername2	箭矢
exp_leg_quivername3	弹药
exp_leg_quivername4	弩矢
exp_leg_quivername5	挎包
exp_leg_quivername6	背包
exp_leg_rangedpropername1	火蛇
exp_leg_rangedpropername10	布理萨
exp_leg_rangedpropername11	伏尔甘
exp_leg_rangedpropername12	欧律托斯
exp_leg_rangedpropername13	大角星
exp_leg_rangedpropername14	疾风之力
exp_leg_rangedpropername15	仙女座
exp_leg_rangedpropername16	李广之弩
exp_leg_rangedpropername17	雷纳
exp_leg_rangedpropername18	子午线
exp_leg_rangedpropername2	塔斯兰
exp_leg_rangedpropername3	薩吉塔
exp_leg_rangedpropername4	阿斯特拉
exp_leg_rangedpropername5	阿波罗
exp_leg_rangedpropername6	阿尔忒弥斯
exp_leg_rangedpropername7	珀耳修斯
exp_leg_rangedpropername8	与一
exp_leg_rangedpropername9	射手座
exp_leg_rangedweaponname1	炮
exp_leg_rangedweaponname2	弩
exp_leg_rangedweaponname3	和平者
exp_leg_rangedweaponname4	箭
exp_leg_rangedweaponname5	弓
exp_leg_ringname1	指环
exp_leg_ringname2	戒指
exp_leg_ringname3	图章戒指
exp_leg_ringname4	环
exp_leg_ringname5	标志
exp_leg_ringpropername1	护身宝符
exp_leg_ringpropername2	尼伯龙根
exp_leg_ringpropername3	奥丁魔戒
exp_leg_ringpropername4	哈耳摩尼亚
exp_leg_ringpropername5	马顿
exp_leg_ringpropername6	安洁莉卡
exp_leg_shieldpropername1	斯瓦林
exp_leg_shieldpropername10	塞德利茨
exp_leg_shieldpropername11	驱邪仪式
exp_leg_shieldpropername12	天体
exp_leg_shieldpropername13	圣女盾
exp_leg_shieldpropername2	杜邦
exp_leg_shieldpropername3	普利杜恩
exp_leg_shieldpropername4	艾瓦拉克血十字盾
exp_leg_shieldpropername5	珂塔卡
exp_leg_shieldpropername6	贾亚瓦丹
exp_leg_shieldpropername7	十二宫
exp_leg_shieldpropername8	美加利西亚
exp_leg_shieldpropername9	赫斯帕里得斯
exp_leg_spearname1	长矛
exp_leg_spearname2	长枪
exp_leg_spearname3	刺叉
exp_leg_spearname4	长戟
exp_leg_spearname5	飞矛
exp_leg_spearname6	阔头枪
exp_leg_spearname7	阔剑
exp_leg_spearpropername1	冈格尼尔
exp_leg_spearpropername2	朗基奴斯
exp_leg_spearpropername3	迦耶伯格
exp_leg_spearpropername4	御手杵
exp_leg_spearpropername5	蜻蛉切
exp_leg_spearpropername6	二郎神
exp_leg_spearpropername7	威尔
exp_leg_staffname1	长杖
exp_leg_staffname2	杖
exp_leg_staffname3	魔杖
exp_leg_staffname4	权杖
exp_leg_staffname5	手杖
exp_leg_staffname6	棍
exp_leg_staffname7	杆
exp_leg_staffname8	短棍
exp_leg_staffname9	小树枝
exp_leg_staffpropername1	死亡命运
exp_leg_staffpropername2	蛇杖
exp_leg_staffpropername3	加姆班泰因
exp_leg_staffpropername4	常春杖
exp_leg_staffpropername5	阿斯克勒庇俄斯
exp_leg_staffpropername6	审判
exp_leg_staffpropername7	复仇女神
exp_leg_staffpropername8	湼盘净土
exp_leg_swordname1	太刀
exp_leg_swordname2	之刀
exp_leg_swordname3	利刃
exp_leg_swordname4	切割刃
exp_leg_swordname5	之剑
exp_leg_swordname6	利刃
exp_leg_swordpropername1	正宗
exp_leg_swordpropername10	提尔锋
exp_leg_swordpropername11	诸神的黄昏
exp_leg_swordpropername2	村正
exp_leg_swordpropername3	断钢剑
exp_leg_swordpropername4	螺旋剑
exp_leg_swordpropername5	佛拉格拉克
exp_leg_swordpropername6	巴尔蒙
exp_leg_swordpropername7	迦伦提恩
exp_leg_swordpropername8	戴因斯莱夫
exp_leg_swordpropername9	雷万汀
exp_leg_whipname1	长鞭
exp_leg_whipname2	皮鞭
exp_leg_whipname3	盘蛇
exp_leg_whipname4	长蛇
exp_leg_whipname5	毒蛇
exp_leg_whippropername1	尘屠
exp_leg_whippropername2	巨龙之须
exp_leg_whippropername3	布伦希尔德之鞭
exp_leg_whippropername4	玫瑰之荆
exp_leg_whippropername5	八蹄马之鞭
exp_log_eatweapon	#cy#^tag1^#ec#吞噬了你的武器^tag2^！
exp_log_error_noportal_mysterydungeon	你不能在这使用#cc#传送门#ec#！
exp_log_healfountain	#cc#喷泉#ec#回复了你的#cg#生命、体力和能量#ec#！
exp_log_mastery_knowitall	这儿#cy#没有更多值得我所学习的了#ec#……
exp_log_monster_atefood	#cy#^tag1^#ec#带走和吃#cy#^tag2^#ec#的#cg#^tag3^#ec#！
exp_log_powerup_absorb	#cy#^tag1^#ec#吸收了增益物品，恢复#cg#^tag2^#ec#生命值！
exp_log_readcombatbook	你阅读了#cy#战斗传记#ec#，获得了#cc#^tag1^#ec#个笔划！
exp_log_resilientmonster	#cy#^tag1^#ec#剩一丝残血！
exp_log_runestone_gone	#cy#^tag1^#ec#消失了，向你注入了#cg#被遗忘的知识#ec#！
exp_log_shara_floorstocampfire	直到你在#cc#营地休息#ec#之前，#cy#^tag1^#ec#会一直倒在主要道路上！
exp_log_shara_noportal	#cr#这里没有#ec##cy#脱离传送阵#ec##cr#让你逃跑……#ec#
exp_log_shieldshatter	^tag1^'s #cc#能量护盾#ec# 破碎！
exp_map_campfire_shara_name	萨拉营地
exp_mapobj_forbiddance_name	禁忌符文
exp_mapobj_letter_name	信
exp_mapobj_oilslick_name	浮油
exp_mapobj_shadoworb_name	近战法球
exp_mapobj_sparks_name	电火花
exp_mapobj_watervapor_name	朦胧水雾
exp_minidreamcaster_name	迷你梦境仪
exp_misc_bonus	加成！
exp_misc_dominated	支配成功
exp_misc_itemupgraded	你的^tag1^已#cy#升级#ec#！
exp_misc_notenoughgold_upgrade	你#cr#没有足够的#ec##cy#金币#ec#升级该道具！
exp_misc_promptlearnskill_fromitem	学习技能#cc#^$getstring:skilltolearn$^#ec# (#cg#^$getstring:itemskilljpcost$^#ec#职业点数）
exp_misc_repeatbuy	这个技能可以购买多次。
exp_misc_slowed	减速！
exp_mm_brigandboost_desc	^number1^盗贼技能伤害
exp_mm_budokaboost_desc	^number1^武道家技能伤害
exp_mm_budokavalid_desc	它不会影响空手战斗
exp_mm_edgethaneboost_desc	^number1^诗领主技能伤害
exp_mm_floramancerboost_desc	^number1^花巫技能伤害（非召唤物）
exp_mm_gamblerboost_desc	^number1^赌客技能伤害
exp_mm_hunterboost_desc	^number1^猎人技能伤害
exp_mm_husynboost_desc	^number1^符晶师技能伤害
exp_mm_paladinboost_desc	^number1^圣骑士技能伤害
exp_mm_passive_armortraining_desc	身穿重甲时，移动技能造成范围伤害（重甲精通）
exp_mm_passive_bloodtracking_desc	击中时：有^number1^几率进行追踪，提升伤害和视野（血色印记）
exp_mm_passive_fatchance_desc	有^number1^几率在吃食物时无视“饱腹”状态（再来一瓶）
exp_mm_passive_gloriousbattler_desc	击败怪物时增强乐曲并获得充能时间（光辉武者）
exp_mm_passive_hazardsweep_desc	有^number1^几率在踩中障碍格子时自动摧毁障碍（障碍扫荡）
exp_mm_passive_herbforaging_desc	有几率从怪物身上获得治疗草药（觅食）
exp_mm_passive_immunology_desc	有^number1^几率无视减益效果，你的减益效果的持续时间更长（免疫学）
exp_mm_passive_qimastery_desc	暴击时：回复能量（气功精通）
exp_mm_passive_thornedskin_desc	有^number1^几率反弹近战伤害（荆棘之肤）
exp_mm_soulkeeperboost_desc	^number1^魂卫技能伤害（非召唤物）
exp_mm_spellshaperboost_desc	^number1^改造前的塑法师召唤技能伤害
exp_mmod_mm_glide_desc	滑行的冷却时间减少^number1^，可更准确地控制滑行降落格子，不会即时进入冷却刷新。
exp_mmod_mm_inkstorm_desc	以^number2^格范围为代价，舞文弄墨每一击可造成额外^number1^伤害。
exp_mmod_mm_waterscroll_desc	流水卷轴的范围提升^number1^格，但伤害降低^number2^
exp_mon_axewielder_name	强盗重击手
exp_mon_batslime_name	阿科霉
exp_mon_bladefrog_name	布雷徳青蛙
exp_mon_boltspirit_name	霹雳魔
exp_mon_bouldertoad_name	湿地三角蛙
exp_mon_budoka_name	强盗武道家
exp_mon_butterfly_name	蝶皇
exp_mon_chameleon_name	变色蜥蜴
exp_mon_chemist2_name	疯狂天才
exp_mon_chonkfrog_name	塔姆塔姆青蛙
exp_mon_cubeslime_name	方型果冻怪
exp_mon_guardianseeker2_name	守护者海盗
exp_mon_komodon2_name	科摩多巨蜥皇
exp_mon_mimic_name	宝箱怪
exp_mon_minicubeslime_name	迷你方型果冻怪
exp_mon_phasmacannon_name	法斯玛炮
exp_mon_pistolshrimp_name	加农虾
exp_mon_robotmantis_name	机器螳螂
exp_mon_scientist_device_name	未知设备
exp_mon_scientist_summoner_name	英格索尔
exp_mon_shara_finalboss_name	核心守护者
exp_mon_shovelgolem_name	铲子骑士
exp_mon_spiritstag_name	幻鹿
exp_mon_staffbandit_name	强盗棍手
exp_mon_tentacle_name	水下追猎者
exp_mon_toxicslime_name	剧毒史莱姆
exp_mon_venomancer_name	强盗毒法师
exp_mon_xp_heavygolem_name	安全傀儡
exp_mon_xp_powerorbiter_name	守护者卫士
exp_monmaker_banditprefix1	强盗
exp_monmaker_banditprefix2	盗贼
exp_monmaker_banditprefix3	草寇
exp_monmaker_banditprefix4	掠夺者
exp_monmaker_banditprefix5	盗贼
exp_monmaker_banditprefix6	飞鸟
exp_monmaker_banditprefix7	海盗
exp_monmaker_banditsuffix1	侦察兵
exp_monmaker_banditsuffix10	中尉
exp_monmaker_banditsuffix11	军士
exp_monmaker_banditsuffix2	探索兵
exp_monmaker_banditsuffix3	新兵
exp_monmaker_banditsuffix4	瞭望兵
exp_monmaker_banditsuffix5	巡逻兵
exp_monmaker_banditsuffix6	观察手
exp_monmaker_banditsuffix7	游击
exp_monmaker_banditsuffix8	小卒
exp_monmaker_banditsuffix9	新手
exp_monmaker_beastconcatprefix1	警戒
exp_monmaker_beastconcatprefix2	敏锐
exp_monmaker_beastconcatprefix3	利刃
exp_monmaker_beastconcatprefix4	庞大
exp_monmaker_beastconcatprefix5	光滑
exp_monmaker_beastconcatprefix6	刚强
exp_monmaker_beastconcatsuffix1	背
exp_monmaker_beastconcatsuffix2	牛
exp_monmaker_beastconcatsuffix3	熊
exp_monmaker_beastconcatsuffix4	爪
exp_monmaker_beastconcatsuffix5	咬
exp_monmaker_beastconcatsuffix6	嘴
exp_monmaker_beastconcatsuffix7	鳞
exp_monmaker_beastconcatsuffix8	巨掌
exp_monmaker_beastprefix1	邋遢
exp_monmaker_beastprefix10	丛林
exp_monmaker_beastprefix11	吃草
exp_monmaker_beastprefix2	咆哮
exp_monmaker_beastprefix3	高贵
exp_monmaker_beastprefix4	肮脏
exp_monmaker_beastprefix5	饥饿
exp_monmaker_beastprefix6	常见
exp_monmaker_beastprefix7	凶猛
exp_monmaker_beastprefix8	云
exp_monmaker_beastprefix9	稳当
exp_monmaker_beastsuffix1	猛兽
exp_monmaker_beastsuffix2	畜牲
exp_monmaker_beastsuffix3	恶兽
exp_monmaker_beastsuffix4	害兽
exp_monmaker_beastsuffix5	野兽
exp_monmaker_beastsuffix6	饕餮
exp_monmaker_coloredprefix1	斑点
exp_monmaker_coloredprefix2	杂色
exp_monmaker_coloredprefix3	斑纹
exp_monmaker_coloredprefix4	雪花
exp_monmaker_coloredprefix5	花斑
exp_monmaker_coloredprefix6	圆点
exp_monmaker_disruptorword1	干扰者
exp_monmaker_disruptorword2	分裂者
exp_monmaker_disruptorword3	咒术师
exp_monmaker_disruptorword4	暴徒
exp_monmaker_frogconcatprefix1	池塘
exp_monmaker_frogconcatprefix2	沼泽
exp_monmaker_frogconcatprefix3	湿地
exp_monmaker_frogconcatprefix4	湖泊
exp_monmaker_frogconcatprefix5	淤泥
exp_monmaker_frogconcatprefix6	光滑
exp_monmaker_frogconcatprefix7	啜食
exp_monmaker_frogconcatprefix8	呱呱
exp_monmaker_frogconcatprefix9	水塘
exp_monmaker_frogconcatsuffix1	跳跃
exp_monmaker_frogconcatsuffix2	弹跳
exp_monmaker_frogconcatsuffix3	舌
exp_monmaker_frogconcatsuffix4	腿
exp_monmaker_frogconcatsuffix5	飞溅
exp_monmaker_frogconcatsuffix6	蛙
exp_monmaker_frogconcatsuffix7	蹼
exp_monmaker_frogprefix1	真实
exp_monmaker_frogprefix2	池塘
exp_monmaker_frogprefix3	沼泽
exp_monmaker_frogprefix4	湿地
exp_monmaker_frogprefix5	常见
exp_monmaker_frogprefix6	鞍背
exp_monmaker_frogprefix7	锄足
exp_monmaker_frogprefix8	大嘴
exp_monmaker_frogprefix9	湿足
exp_monmaker_frogsuffix1	蟾蜍
exp_monmaker_frogsuffix2	青蛙
exp_monmaker_frogsuffix3	呱呱蛙
exp_monmaker_frogsuffix4	跳跳蛙
exp_monmaker_frogsuffix5	蝌蚪
exp_monmaker_grasstreeword1	藤蔓
exp_monmaker_grasstreeword2	苔藓
exp_monmaker_grasstreeword3	树
exp_monmaker_grasstreeword4	灌木
exp_monmaker_grasstreeword5	树丛
exp_monmaker_grasstreeword6	植物
exp_monmaker_hybridprefix1	坚固
exp_monmaker_hybridprefix2	笨重
exp_monmaker_hybridprefix3	结实
exp_monmaker_hybridsuffix1	傀儡
exp_monmaker_hybridsuffix2	土偶
exp_monmaker_hybridsuffix3	图腾
exp_monmaker_insectprefix1	常见
exp_monmaker_insectprefix2	条纹
exp_monmaker_insectprefix3	筑巢
exp_monmaker_insectprefix4	陶艺
exp_monmaker_insectprefix5	秃头
exp_monmaker_insectsuffix1	臭虫
exp_monmaker_insectsuffix2	害虫
exp_monmaker_insectsuffix3	昆虫
exp_monmaker_insectsuffix4	寄生虫
exp_monmaker_meleeword1	格斗家
exp_monmaker_meleeword2	角斗士
exp_monmaker_meleeword3	拳师
exp_monmaker_meleeword4	掠夺者
exp_monmaker_naturalgrowthprefix1	有机
exp_monmaker_naturalgrowthprefix2	荆棘
exp_monmaker_naturalgrowthprefix3	自然
exp_monmaker_naturalgrowthprefix4	根
exp_monmaker_naturalgrowthprefix5	生机勃勃
exp_monmaker_naturalgrowthprefix6	勃发
exp_monmaker_naturalgrowthsuffix1	生长物
exp_monmaker_naturalgrowthsuffix2	隆起
exp_monmaker_naturalgrowthsuffix3	嫩枝
exp_monmaker_naturalgrowthsuffix4	萌芽
exp_monmaker_naturalgrowthsuffix5	爬藤
exp_monmaker_naturalgrowthsuffix6	赘生
exp_monmaker_rangedword1	狙击手
exp_monmaker_rangedword2	猎人
exp_monmaker_rangedword3	神枪手
exp_monmaker_rangedword4	掠食者
exp_monmaker_rangedword5	游侠
exp_monmaker_robotconcatprefix1	铬合金
exp_monmaker_robotconcatprefix2	打斗
exp_monmaker_robotconcatprefix3	侦察
exp_monmaker_robotconcatprefix4	哨兵
exp_monmaker_robotconcatprefix5	保卫
exp_monmaker_robotconcatprefix6	士兵
exp_monmaker_robotconcatprefix7	战斗
exp_monmaker_robotconcatsuffix1	机器人
exp_monmaker_robotconcatsuffix2	器
exp_monmaker_robotconcatsuffix3	仪
exp_monmaker_robotprefix1	哨兵
exp_monmaker_robotprefix2	守护者
exp_monmaker_robotprefix3	卫兵
exp_monmaker_robotprefix4	监护人
exp_monmaker_robotprefix5	管理人
exp_monmaker_robotprefix6	守卫
exp_monmaker_robotsuffix1	机器人
exp_monmaker_robotsuffix2	机器人
exp_monmaker_robotsuffix3	人形机器人
exp_monmaker_robotsuffix4	无人机
exp_monmaker_robotsuffix5	机甲
exp_monmaker_slimeconcatprefix1	蜜糖
exp_monmaker_slimeconcatprefix2	洞穴
exp_monmaker_slimeconcatprefix3	湿润
exp_monmaker_slimeconcatprefix4	飞溅
exp_monmaker_slimeconcatprefix5	泡泡
exp_monmaker_slimeconcatprefix6	水滴
exp_monmaker_slimeconcatprefix7	果冻怪
exp_monmaker_slimeconcatprefix8	霉变
exp_monmaker_slimeconcatsuffix1	滴落
exp_monmaker_slimeconcatsuffix2	发霉
exp_monmaker_slimeconcatsuffix3	嗝噜
exp_monmaker_slimeconcatsuffix4	噗噜
exp_monmaker_slimeconcatsuffix5	粘胶
exp_monmaker_slimeprefix1	滴水
exp_monmaker_slimeprefix10	粘质
exp_monmaker_slimeprefix11	洞穴
exp_monmaker_slimeprefix2	渗漏
exp_monmaker_slimeprefix3	滴沥
exp_monmaker_slimeprefix4	穿洞
exp_monmaker_slimeprefix5	邋遢
exp_monmaker_slimeprefix6	湿润
exp_monmaker_slimeprefix7	泼溅
exp_monmaker_slimeprefix8	胶状
exp_monmaker_slimeprefix9	凝固
exp_monmaker_slimesuffix1	果冻怪
exp_monmaker_slimesuffix2	史莱姆
exp_monmaker_slimesuffix3	霉菌
exp_monmaker_slimesuffix4	凝胶
exp_monmaker_snakesuffix1	长蛇
exp_monmaker_snakesuffix2	毒蛇
exp_monmaker_snakesuffix3	响尾蛇
exp_monmaker_snakesuffix4	眼镜蛇
exp_monmaker_snakesuffix5	蟒蛇
exp_monmaker_snakesuffix6	树眼镜蛇
exp_monmaker_snakesuffix7	太攀蛇
exp_monmaker_spiritconcatprefix1	尼尔布
exp_monmaker_spiritconcatprefix2	莱什
exp_monmaker_spiritconcatprefix3	瓦尔纳
exp_monmaker_spiritconcatprefix4	索尔
exp_monmaker_spiritconcatprefix5	克奥
exp_monmaker_spiritconcatprefix6	托格
exp_monmaker_spiritconcatprefix7	曼
exp_monmaker_spiritconcatprefix8	莫尔
exp_monmaker_spiritconcatprefix9	德拉姆
exp_monmaker_spiritconcatsuffix1	恩
exp_monmaker_spiritconcatsuffix2	阿里
exp_monmaker_spiritconcatsuffix3	伊丁
exp_monmaker_spiritconcatsuffix4	埃斯
exp_monmaker_spiritconcatsuffix5	奥斯
exp_monmaker_spiritconcatsuffix6	奥里
exp_monmaker_spiritconcatsuffix7	阿温
exp_monmaker_spiritconcatsuffix8	阿维
exp_monmaker_spiritprefix1	复仇
exp_monmaker_spiritprefix2	孤寂
exp_monmaker_spiritprefix3	可怕
exp_monmaker_spiritprefix4	徘徊
exp_monmaker_spiritprefix5	迷失
exp_monmaker_spiritprefix6	流浪
exp_monmaker_spiritprefix7	秘密
exp_monmaker_spiritsuffix1	灵体
exp_monmaker_spiritsuffix10	风精
exp_monmaker_spiritsuffix11	游灵
exp_monmaker_spiritsuffix2	元素怪
exp_monmaker_spiritsuffix3	鬼魂
exp_monmaker_spiritsuffix4	妖精
exp_monmaker_spiritsuffix5	灵素
exp_monmaker_spiritsuffix6	幽灵
exp_monmaker_spiritsuffix7	恶灵
exp_monmaker_spiritsuffix8	邪灵
exp_monmaker_spiritsuffix9	鬼火
exp_monmaker_statususerword1	萨满
exp_monmaker_statususerword2	祭师
exp_monmaker_statususerword3	占卜师
exp_monmaker_strongfireprefix1	炼狱
exp_monmaker_strongfireprefix2	烈火
exp_monmaker_strongfireprefix3	烈焰
exp_monmaker_stronglightningprefix1	电击
exp_monmaker_stronglightningprefix2	雷鸣
exp_monmaker_stronglightningprefix3	天雷
exp_monmaker_strongpoisonprefix1	剧毒
exp_monmaker_strongpoisonprefix2	硫酸
exp_monmaker_strongpoisonprefix3	鸩毒
exp_monmaker_strongshadowprefix1	暗夜
exp_monmaker_strongshadowprefix2	恐怖
exp_monmaker_strongshadowprefix3	黑影
exp_monmaker_strongshadowprefix4	虚空
exp_monmaker_strongwaterprefix1	暴雨
exp_monmaker_strongwaterprefix2	洪水
exp_monmaker_strongwaterprefix3	冰河
exp_monmaker_strongwaterprefix4	极地
exp_monmaker_summonerword1	召唤师
exp_monmaker_summonerword2	魔法师
exp_monmaker_summonerword3	呼唤者
exp_monmaker_supporterword1	支援者
exp_monmaker_supporterword2	辅助者
exp_monmaker_supporterword3	医师
exp_monmaker_supporterword4	巫士
exp_monmaker_weakfireprefix1	火
exp_monmaker_weakfireprefix2	火焰
exp_monmaker_weakfireprefix3	余烬
exp_monmaker_weakfireprefix4	热气
exp_monmaker_weaklightningprefix1	电光
exp_monmaker_weaklightningprefix2	闪电
exp_monmaker_weaklightningprefix3	霹雳
exp_monmaker_weakpoisonprefix1	毒液
exp_monmaker_weakpoisonprefix2	瘟疫
exp_monmaker_weakpoisonprefix3	淤泥
exp_monmaker_weakpoisonprefix4	污泥
exp_monmaker_weakshadowprefix1	阴蔽
exp_monmaker_weakshadowprefix2	黑暗
exp_monmaker_weakshadowprefix3	薄暮
exp_monmaker_weakshadowprefix4	阴暗
exp_monmaker_weakwaterprefix1	细雨
exp_monmaker_weakwaterprefix2	水塘
exp_monmaker_weakwaterprefix3	寒冷
exp_monmaker_weakwaterprefix4	寒气
exp_monmaker_weakwaterprefix5	冰冻
exp_monmaker_weakwaterprefix6	冰霜
exp_monmod_firegod	火焰之神
exp_monmod_lightninggod	闪电之神
exp_monmod_physicalgod	剑神
exp_monmod_poisongod	剧毒之神
exp_monmod_shadowgod	暗影之神
exp_monmod_watergod	水之神
exp_mysterydungeon_bossname	~ 神秘的王 ~
exp_mysterydungeon_bossvictory	#clr#神秘的王#ec#被打败了！此次旅途将在你使用#cc#魔法传送门#ec#时结束。\n\n
exp_mysterydungeon_explanation	#big##clr#流浪者旅途#ec##endbig#\n\n在这次冒险中，你必须到达#cy#最高层#ec#并在那里打败#clr#神秘的王#ec#。与道具之梦不同，你#cr#可能不会#ec#返回城镇！\n\n在这里你只会找到#cy#上行楼梯#ec#，无#cr#后退之路#ec#。但是，你偶尔仍会找到#cy#篝火楼层#ec#。\n\n这里的所有#cy#怪物#ec#都是全新的。你要小心观察，了解它们的#cc#能力和行为#ec#。祝你好运！\n\n
exp_mysterydungeon_postvictory	#big##clr#流浪者旅途#ec#完成！#endbig#\n\n
exp_mysterydungeon_tip0	每次#clr#流浪者旅途#ec#的怪物都是全新的。小心观察它们！
exp_mysterydungeon_tip1	你可以在#clr#流浪者旅途中#ec#找到强大和独特的#clr#圣物#ec#。
exp_mysterydungeon_tip2	在#clr#流浪者旅途中#ec#你不能返回城镇，所以在商人处消耗金币时不要手软！
exp_mysterydungeon_tip3	在#clr#流浪者旅途中#ec##cy#篝火#ec#每几层出现一次。请明智地使用它们……
exp_obj_blackhole_name	黑洞
exp_overload_dmg_name	超载
exp_parry_down	招架率下降！
exp_popup_misc_sticky	被舌头黏住了！
exp_randomshop1_name	诺尔曼多
exp_randomshop2_name	费尔南多
exp_randomshop3_name	奥兰多
exp_randomshop4_name	赫尔南多
exp_randomshop5_name	登多
exp_randomshop6_name	谢尔兰多
exp_rarity_relic	圣物
exp_shara_died	纷乱深渊用各种方式讲述着无尽的故事。在今天的故事中，#cc#萨拉的传说#ec#终结在此，但是她的#cy#目标#ec#还没有实现，这会是真正的结局吗？
exp_shara_dominate_description1	用非元素系能量攻击怪物，可以永久地让怪物处于^tag1^负面状态。你最多可以让^tag2^个怪物处于这种状态下。
exp_shara_dominate_description2	用非元素系能量攻击怪物，可以永久地让怪物处于^tag1^负面状态以达成你伟大的使命。你最多可以让^tag2^个怪物处于这种状态下。
exp_shara_dominate_displayname1	温柔的拳
exp_shara_dominate_displayname2	斥责招募
exp_shara_dominate_displayname3	威严一击
exp_shara_dominate_displayname4	支配
exp_shara_dominate_extradesc1	伤害：^number1^精神力的物理伤害。永久地^tag1^低于^number2^生命的非精英怪。主要的魅惑目标会回复你的生命值。
exp_shara_dominate_extradesc2	伤害：^number1^精神力的物理伤害。永久地控制低于^number2^生命的非精英怪。被控制的怪物会缓慢的失去生命值。当主要控制目标死亡时，他们会为你回复最大生命值、能量、体力的^number3^。
exp_shara_ko	萨拉面临过许多强大的敌人，也从许多困境中逃脱出来过。<color=yellow>^tag2^</color>的<color=#0cffe6>^tag1^</color>这次击败了她，但是她不会放弃。没有任何人能阻止她实现她#cy#目标#ec#。
exp_shara_ko_result	萨拉在逃脱时丢下了<color=yellow>^tag1^</color>g，并花了<color=#40b843>^tag2^职业点数</color>来回复。
exp_sharaending_text1	这个热情的女人身上还有许多的疑问，
exp_sharaending_text2	但我想知道的是：
exp_sharaending_text3	她究竟是敌人还是是朋友？
exp_sharaending_text4	我不会让任何人阻止我完成我的使命，但是……
exp_sharaending_text5	也许我们可以一起重建这个世界……
exp_sharafinalboss_phase2begin_1	#cy#已请求支援。#ec#当前武器无法承受来自#cc#SHARA_AVATAR的攻击。#ec#\n\n#cc#^tag1^时间单位#ec#正进入紧急再生停滞状态。\n\n
exp_sharafinalboss_phase2begin_2	哈！机器，我似乎察觉到了一丝#cr#恐惧#ec#？\n\n为了这一刻，我磨练了自己的能力。没有你，我将#cc#支配#ec#你的新盟友，让他们转而与你为敌！\n\n
exp_sharafinalboss_phase2end_1	再生循环完成。运行状态：#cg#完全恢复#ec#。\n\n
exp_sharaforest_levelname	梦幻之森
exp_sharamode_tips0	如果你的#cr#生命值#ec#全满，#cc#魔法之泉#ec#会补充#cc#能量护盾#ec#并重置冷却。
exp_sharamode_tips1	萨拉的等级通过#cy#消耗职业点数#ec#增加。这会提升她的武器伤害和精神力。
exp_sharamode_tips2	萨拉每次使用职业点数升级一个#cr#核心数值#ec#，就会增加#cy#生命值#ec#。
exp_sharamode_tips3	开启#cy#潘多拉魔盒#ec#或在#cy#篝火#ec#处休息，即可学习新技能。
exp_sharamode_tips4	你的技能选择每次都是随机的，所以#cy#请认真考虑每次选择#ec#。
exp_sharamode_tips5	有很多可探索的#cg#边缘区域#ec#，你不需要打听#cg#传闻#ec#去找。
exp_sharamode_tips6	萨拉可以从#cy#技能页#ec#使用技能，并自由安排#cy#快捷栏#ec#，即使在危险区域也是如此。
exp_sharamode_tips7	你找到的每一个#cy#篝火#ec#附近都会有一名商人。
exp_sharamode_tips8	在#cc#萨拉的故事#ec#中，#cy#潘多拉魔盒#ec#必定装有一件强大装备！
exp_sharapower_learned_txt	#cc#萨拉#ec#能比#cy#米莱#ec#更自由地使用能力！你能直接从#cy#技能页#ec#使用技能而不用把他们放进快捷栏。\n\n你也能在危险的区域#cy#设置或删除#ec#快捷栏。#cg#被动技能#ec#也一样可以。\n\n
exp_skill_axeiaijutsu_name	斧斧生风
exp_skill_banish_description	立即消灭非精英召唤怪或陷阱。
exp_skill_banish_displayname	驱逐
exp_skill_boostdiscipline_desc	戒律的最大值上升^number1^。
exp_skill_boostdiscipline_name	戒律强化
exp_skill_boostguile_desc	狡黠的最大值上升^number1^。
exp_skill_boostguile_name	狡黠强化
exp_skill_boosthealth_desc	生命的最大值上升^number1^。
exp_skill_boosthealth_name	生命强化
exp_skill_boostspirit_desc	精神的最大值上升^number1^。
exp_skill_boostspirit_name	精神强化
exp_skill_booststrength_desc	力量的最大值上升^number1^。
exp_skill_booststrength_name	力量强化
exp_skill_boostswiftness_desc	迅捷的最大值上升^number1^。
exp_skill_boostswiftness_name	迅捷强化
exp_skill_chakrashift_desc	吸收并移除自身的暂时性增益效果，每移除一个增益效果，可提升^number1^伤害，持续^number2^回合。
exp_skill_chakrashift_name	斗转星移
exp_skill_charisma_desc	被强盗类非精英怪攻击时有^number1^几率^$sharamode:dominateverb$^它们。
exp_skill_charisma_name	魅力
exp_skill_cleanup_desc	立即移除一个拥有暂时性陷阱的格子，例如冰块、火焰或酸液池。
exp_skill_cleanup_name	擦擦干净
exp_skill_collectivestrength_desc	被控制的每个怪物会让你普通攻击附带^number1^伤害（最大：^number2^）
exp_skill_collectivestrength_name	力之聚集
exp_skill_combatbiography_desc	在神秘的传记中记录你的冒险之旅，消耗全部笔划并召唤附近的书。拾取此书将归还所有已用的笔划及额外^number1^个笔划，并在短时间内强化书法家技能。
exp_skill_combatbiography_extradesc	同一时间内只能有一本传记。所召唤的传记可持续^number2^回合。拾取传记后^number4^回合内，书法家技能伤害提升^number3^。
exp_skill_combatbiography_name	战斗传记
exp_skill_combatbiography_shortdesc	召唤一本神秘的书至附近的一个随机格子，书中包含所有笔划。
exp_skill_commandingpresence_description	（被动）你所控制的每一个怪物会提升你在普通攻击时^number1^的几率^$sharamode:dominateverb$^怪物。
exp_skill_commandingpresence_extradesc	攻击时最多有^number2^几率^$sharamode:dominateverb$^怪物。
exp_skill_commandingpresence_name	威严
exp_skill_createrandomrock_name	制造碎石
exp_skill_dangermagnet_desc	你越来越会招惹麻烦，游荡怪物的数量增加^number1^。
exp_skill_dangermagnet_name	危险磁铁
exp_skill_dominate_description	^$sharamode:dominatedesc$^
exp_skill_dominate_displayname	^$sharamode:dominatename$^
exp_skill_dominate_extradesc	^$sharamode:dominateedesc$^
exp_skill_elemabsorb_name	元素屏障
exp_skill_eshieldpower_desc	（被动）利用能量护盾破碎后释放出的能量，直到你能再次释放一个能量护盾前获得^number1^伤害提升。
exp_skill_eshieldpower_name	复仇
exp_skill_essencestorm_desc	用你生命本质的力量制造^number1^个能量球，每回合会有一个能量球攻击一个附近的怪物。
exp_skill_essencestorm_extradesc	伤害：每次^number2^精神力的物理伤害。最多攻击^number3^格内的敌人。
exp_skill_essencestorm_name	生命风暴
exp_skill_expmon_overdrive_name	过载
exp_skill_expmon_photonbreath_name	光子吐息
exp_skill_expmon_randomphoton_name	光子风暴
exp_skill_expmon_shielding_name	能量护盾
exp_skill_expmon_summoncannondrones_name	召唤无人机
exp_skill_flowshield_description	基于你的生命值制造一个护盾来吸收所有伤害。护盾的大小是你最大生命值的^number1^。
exp_skill_flowshield_displayname	生命护盾
exp_skill_flowshield_extradesc	在护盾未被破坏前冷却时间不会减少。
exp_skill_forbiddance_desc	消耗全部笔划，在前方格子里写出强力的魔法符文。敌人踩中符文时将受到封印和绊足。
exp_skill_forbiddance_extradesc	每使用一个笔划可创造一个持续^number1^回合的符文。封印和绊足效果持续^number2^回合。
exp_skill_forbiddance_name	禁忌
exp_skill_glide_desc	优雅地飞跃至一段短距离外，可横跨^number1^个格子。
exp_skill_glide_extradesc	每使用两次后，技能进入冷却。
exp_skill_glide_name	滑行
exp_skill_improveddominate_description	（被动） ^$sharamode:getdominatename$^可以魅惑生命值^number1^或以下的怪物。
exp_skill_improveddominate_name	魅力提升
exp_skill_inkcollector_desc	每次打败一个琐碎（或以上）怪物、闪避攻击或造成暴击时，都会储存一个笔划。
exp_skill_inkcollector_name	惜墨如金
exp_skill_inkstorm_desc	消耗全部笔划，随机对附近的敌人发起猛烈攻击。
exp_skill_inkstorm_extradesc	伤害：^number1^武器威力。每一个笔划可增加一次额外攻击。重复攻击同一个敌人时造成^number2^伤害。不会生成新的笔划。
exp_skill_inkstorm_name	舞文弄墨
exp_skill_lightningflash_desc	瞬间闪到目标位置，同时电气化所有相邻格子。
exp_skill_lightningflash_extradesc	被电气化的格子会在怪兽踏入后麻痹^number1^个回合。
exp_skill_lightningflash_name	电光一闪
exp_skill_lightningscroll_desc	沿一条直线射出闪电，造成伤害，同时产生持久不散的电火花。
exp_skill_lightningscroll_extradesc	伤害：^number1^武器威力和^number2^精神力的电属性伤害。电火花能提供可叠加的^number3^暴击率提升效果，将在下次攻击时生效。
exp_skill_lightningscroll_name	闪电卷轴
exp_skill_menagerie_desc	每控制一只宠物或召唤生物，你的宠物和召唤生物可造成额外^number1^伤害。
exp_skill_menagerie_name	兽群
exp_skill_monstertoss_desc	举起附近的一只怪物并将其扔向另一只怪物！
exp_skill_monstertoss_extradesc	对两只怪物所造成的伤害：遭投掷怪物血量的^number1^。
exp_skill_monstertoss_name	怪物投掷
exp_skill_museofmelee_desc	基础近战攻击有^number1^几率造成^number2^水、电或暗属性抗性，持续^number3^回合。双持武器时，每次攻击都有机会触发此效果。
exp_skill_museofmelee_name	近战女神
exp_skill_necessarysacrifice_desc	当一个被魅惑的生物死亡时，你可以回复^number1^的最大体力和能量。
exp_skill_necessarysacrifice_name	补充
exp_skill_phasechange_desc	和怪物交换位置并使他们混乱。
exp_skill_phasechange_extradesc	混乱持续^number1^个回合。
exp_skill_phasechange_name	移形换影
exp_skill_phasmashield_description	在你相邻的格子召唤一圈死亡法斯玛能量保护你。怪物触碰后会受到伤害。
exp_skill_phasmashield_extradesc	每回合伤害：^number1^精神力和^number2^武器伤害的火属性伤害。
exp_skill_phasmashield_name	法斯玛盾
exp_skill_precisefinish_desc	华丽的一击，威力较低。使用此技能打败敌人时，可获得更多奖励。
exp_skill_precisefinish_extradesc	伤害：^number1^武器威力。使用此技能打败怪物时，可获得额外^number2^奖励。
exp_skill_precisefinish_name	精确终技
exp_skill_relichunter_desc	无价的古物给你注入永恒的力量！每装备一件传奇、圣物或套装物品，伤害和抗性可提升^number1^。
exp_skill_relichunter_name	圣物猎人
exp_skill_retort_desc	严阵以待，轻松躲过下一次物理攻击，并通过封印攻击者来进行反击。
exp_skill_retort_extradesc	闪避加成可持续^number1^回合，或在下一次被击中时失效。可封印攻击者，持续^number2^回合。
exp_skill_retort_name	后发制人
exp_skill_rockcircle_name	活埋
exp_skill_scholar_desc	你对学习的追求永无止境，获得^number1^职业点数。
exp_skill_scholar_name	学者
exp_skill_shadowscroll_desc	用可怕的暗影爆发来轰炸一片区域，造成伤害，同时产生持久不散的暗影法球。
exp_skill_shadowscroll_extradesc	伤害：^number1^武器威力和^number2^精神力的暗影属性伤害。对受影响的敌人施加可叠加的暗影易伤效果。短时间内，暗影法球提供可叠加的^number3^近战基础攻击伤害加成效果。
exp_skill_shadowscroll_name	暗影卷轴
exp_skill_shockwave_description	制造一个不断变大的电圈攻击圆圈内的敌人。
exp_skill_shockwave_extradesc	伤害： ^number1^精神力的电属性伤害。
exp_skill_shockwave_name	冲击波
exp_skill_sludgespread_name	污泥蔓延
exp_skill_subtletap_desc	不足以打败敌人的近战攻击。
exp_skill_subtletap_extradesc	伤害：^number1^武器威力。此攻击无法将怪物的生命值降低至1以下。
exp_skill_subtletap_name	轻轻敲打
exp_skill_summontoxicslime_name	召唤剧毒史莱姆
exp_skill_treasuretracker_desc	借助对隐藏的宝藏和财富的敏锐感知，所有增益物品中的^number1^生成时为金币堆。
exp_skill_treasuretracker_name	宝藏追踪
exp_skill_truehover_description	（被动）漂浮术可以让你减少^number1^的来自地面伤害
exp_skill_truehover_name	真漂浮术
exp_skill_vanishingdodge_desc	生命值降至^number1^或以下时，隐形墨水将会笼罩你，使你提升^number2^闪避率。
exp_skill_vanishingdodge_name	消失墨水
exp_skill_venomancerpoison_name	淬毒武器
exp_skill_voidbolt_description	向敌人发射一道集中的虚空能量冲击，造成伤害并使其每回合都会流失生命。
exp_skill_voidbolt_displayname	虚空一击
exp_skill_voidbolt_extradesc	伤害：^number1^武器伤害的物理伤害。基于已损失生命造成最多^number2^伤害。受到攻击的敌人在^number4^回合内，每回合流失^number3^生命。
exp_skill_voidshield_description	基于你的生命值制造一个负能量护盾来吸收所有伤害。护盾的大小是你最大生命值的^number1^。护盾激活时有一定概率随机释放虚空一击。
exp_skill_voidshield_displayname	虚空护盾
exp_skill_voidshield_extradesc	释放时会取消掉生命护盾；释放生命护盾也会取消虚空护盾。每个回合有^number2^几率对周围敌人释放虚空一击。
exp_skill_waterscroll_desc	用汹涌的水流淹没一片区域，可造成伤害，同时产生持久不散的水汽。
exp_skill_waterscroll_extradesc	伤害：^number1^武器威力和^number2^精神力的水属性伤害。朦胧水雾可克制火属性伤害，同时使你提升^number3^闪避率。
exp_skill_waterscroll_name	流水卷轴
exp_status_attackdown_name	无力攻击
exp_status_brushstroke_desc	储存能量，可通过使用笔墨攻击来释放其威力。
exp_status_brushstroke_name	笔划
exp_status_combatbiography_boost_name	传记提升
exp_status_dmgup_25_desc	伤害提升^number1^
exp_status_essencestorm_desc	每回合会有一个剩余的能量球攻击一个附近的敌人。#cy#能量球剩余：#ec# #cg#^$getactordata:essencestorm_ammo$^#ec#
exp_status_extracrit_desc	有^number1^几率造成暴击。下次攻击或使用技能时生效。
exp_status_flowshield_desc	能量护盾能吸收所有伤害。#cy#护盾剩余大小：#ec# #cg#^$getactordata:flowshield_dmgleft$^#ec#
exp_status_parrydown_name	无力招架
exp_status_robo_overdriveattack_name	过载攻击
exp_status_shadoworb_desc	^number1^近战武器基础攻击伤害
exp_superhardarea_name	诸神领域
exp_superhardarea_name_1	诸神领域 1层
exp_superhardarea_name_2	诸神领域 2层
exp_superhardarea_name_3	诸神领域 3层
exp_superhardarea_name_4	诸神领域 4层
exp_superhardarea_name_5	诸神领域 5层
exp_verb_charm	魅惑
exp_verb_command	掌握
exp_verb_dominate	支配
exp_verb_recruit	招募
exp_wanderer_askgods	#cy#？？？流浪者#ec#：返回你#cc#击败萨拉#ec#的地方，通往#co#诸神领域#ec#的入口在等着你。\n
exp_wanderer_dungeon1_desc	#big#山之复仇#endbig#\n\n#cy#层数#ec#：20\n#cy#难度#ec#：#cr#^$gettext:difficulty_7$^#ec#\n^$gettext:md_startwithnothing$^\n^$gettext:md_ondefeat_loseprogress$^\n^$gettext:md_keeprelics$^\n\n^$gettext:md_monsters_respawn$^\n\n
exp_wanderer_dungeon1_name	山之复仇
exp_wanderer_dungeon10_desc	#big#南国的宝藏#endbig#\n\n#cy#层数#ec#：15\n#cy#难度#ec#:：^$gettext:difficulty_5$^\n^$gettext:md_startwithnothing$^\n^$gettext:md_ondefeat_loseprogress$^\n^$gettext:md_keepgold_items_relics$^\n\n^$gettext:md_monsters_respawn$^\n^$gettext:md_jp_only_campfires$^\n^$gettext:md_more_consumables$^\n\n
exp_wanderer_dungeon10_name	南国的宝藏
exp_wanderer_dungeon2_desc	#big#精灵的寺院#endbig#\n\n#cy#层数#ec#：30\n#cy#难度#ec#：#cr#^$gettext:difficulty_8$^#ec#！\n#cy#初始条件#ec#：带有技能和已装备上的装备\n^$gettext:md_ondefeat_loseprogress$^\n^$gettext:md_keepgold_items_relics$^\n\n^$gettext:md_monsters_respawn$^\n\n
exp_wanderer_dungeon2_name	精灵的寺院
exp_wanderer_dungeon3_desc	#big#黄金蛙的巨大洞穴#endbig#\n\n#cy#层数#ec#：15\n#cy#难度#ec#: ^$gettext:difficulty_5$^\n^$gettext:md_startwithnothing$^\n^$gettext:md_ondefeat_loseprogress$^\n^$gettext:md_keepgold_relics$^\n\n^$gettext:md_monsters_respawn$^\n^$gettext:md_nodrops$^\n^$gettext:md_shopkeepers$^\n\n
exp_wanderer_dungeon3_name	黄金蛙的巨大洞穴
exp_wanderer_dungeon4_desc	#big#守护者废墟#endbig#\n\n#cy#层数#ec#：15\n#cy#难度#ec#: ^$gettext:difficulty_5$^\n^$gettext:md_startwithnothing$^\n^$gettext:md_ondefeat_loseprogress$^\n^$gettext:md_keeprelics$^\n\n^$gettext:md_monsters_respawn$^\n\n
exp_wanderer_dungeon4_name	守护者废墟
exp_wanderer_dungeon5_desc	#big#王座之间#endbig#\n\n#cy#层数#ec#：12\n#cy#难度#ec#：#cr#^$gettext:difficulty_8$^#ec#\n#cy#初始条件#ec#：带有能力值、装备和技能\n^$gettext:md_ondefeat_loseprogress$^\n^$gettext:md_keeprelics$^\n\n^$gettext:md_many_champions$^\n\n
exp_wanderer_dungeon5_name	王座之间
exp_wanderer_dungeon6_desc	#big#试炼之塔#endbig#\n\n#cy#层数#ec#：50\n#cy#难度#ec#：#cr#^$gettext:difficulty_8$^#ec#！\n^$gettext:md_startwithnothing$^\n^$gettext:md_ondefeat_loseprogress$^\n^$gettext:md_keepgold_items_relics$^\n\n^$gettext:md_monsters_respawn$^\n\n这是#cr#最终的挑战#ec#！\n\n
exp_wanderer_dungeon6_name	试炼之塔
exp_wanderer_dungeon7_desc	#big#折麽的狩猎#endbig#\n\n#cy#层数#ec#：15\n#cy#难度#ec#：#cr#^$gettext:difficulty_7$^#ec#\n^$gettext:md_startwithnothing$^\n^$gettext:md_ondefeat_loseprogress$^\n^$gettext:md_keepgold_relics$^\n\n^$gettext:md_monsters_respawn$^\n^$gettext:md_king_chaser$^\n\n
exp_wanderer_dungeon7_name	折磨的狩猎
exp_wanderer_dungeon8_desc	#big#混沌工厂#endbig#\n\n#cy#层数#ec#：15\n#cy#难度#ec#：？？？\n#cy#初始状态#ec#：从没有装备、技能和宠物的1级开始，但是获得10个伪装香水。\n^$gettext:md_ondefeat_loseprogress$^\n^$gettext:md_keeprelics$^\n\n^$gettext:md_monster_powerup$^\n^$gettext:md_monsters_respawn$^\n#cc^$gettext:md_items_breakables$^\n\n
exp_wanderer_dungeon8_name	混沌工厂
exp_wanderer_dungeon9_name	高山坡路
exp_wanderer_dungeonlistbranch	#cy#？？？ 流浪者#ec#：每个故事本身就是一趟旅途。一旦我们开始，直至旅途结束之前，你都#cr#可能无法回到这个世界#ec#。毕竟，无法让人全心投入沉浸的故事又有何意义呢？\n\n进入某些故事时，你将无法携带任何#cy#物品#ec#或#cy#技能#ec#。故事结束时，它们将会返还给你。\n\n如果你成功完成故事，你将可获得该旅途的独特#cy#奖励#ec#，但胜利来之不易。每个故事都是独一无二的。\n\n
exp_wanderer_firstvictory_1	#cy#？？？ 流浪者#ec#：欢迎回来，探索者。\n\n你应该还#cg#挺喜欢#ec#我所说的故事吧？\n\n
exp_wanderer_firstvictory_2	#cy#？？？ 流浪者#ec#：某种意义上来说，#cg#你确实是身临其境#ec#。\n\n你找到的#clr#圣物#ec#不正在你的背包里么？\n\n
exp_wanderer_firstvictory_3	#cy#？？？ 流浪者#ec#：我该怎么解释呢？我诉说的故事就像#cc#湖泊#ec#一般，你在其中#cy#畅泳#ec#。\n\n故事结束时，你从水中起身。离开时，你在湖中掀起阵阵#cy#涟漪#ec#，同时身上亦带了不少湖水回来。\n\n换一种方式来说，你在#clr#故事#ec#中找到的一些东西，可以被#cy#带回这里#ec#。现在你明白了吗？\n\n
exp_wanderer_firstvictory_4	#cy#？？？流浪者#ec#：正如我所料。一直以来，我都在寻找与我志趣相投的人，希望能与他分享这些故事，我仍然有#cy#非常多的故事#ec#要与你分享。\n\n所有旅途都是独一无二的：每一次重新讲述时，旅途都会产生变化，而且每趟旅途都有其独特的#cg#奖励#ec#和#cr#挑战#ec#。\n\n#clr#高山坡路#ec#是最简单的故事。现在，让我来跟你讲讲其他故事吧。\n\n
exp_wanderer_firstvictory_response1	太棒了！简直让我觉得身临其境。
exp_wanderer_firstvictory_response2	是的，但……这怎么可能？！
exp_wanderer_firstvictory_response3	明白了，我还想再多听一个故事！
exp_wanderer_mainbranch	#cy#？？？ 流浪者#ec#：你好，探索者。\n\n你不如过来坐坐，和我一起看看流水吧。\n\n对于世界这块壮丽的挂毯来说，像这样的溪流微不足道。挂毯上的每根线都有其各自的#cy#旅途#ec#，对吧？\n
exp_wanderer_mainbranch_askgods	#co#诸神领域#ec#在哪里？
exp_wanderer_mainbranch_response1	你似乎有过不少冒险经历。
exp_wanderer_mainbranch_response2	给我讲个故事吧！
exp_wanderer_realmofgods_continue_1	#cy#？？？流浪者#ec#：这是我真正的样貌。别害怕。\n\n
exp_wanderer_realmofgods_continue_2	#cy#？？？流浪者#ec#：跟你一样，我也是探索者。离开家后，我在世上流浪了#cy#数千年#ec#。其实我在我族中算是#cy#独特的#ec#。\n\n在#co#诸神领域#ec#居住的其他生物毫不关心你们，或#cg#纷乱深渊#ec#的任何生物。\n
exp_wanderer_realmofgods_continue_3	#cy#？？？流浪者#ec#：没错。他们认为居住在#cg#纷乱深渊#ec#的生物全居于他们之下，不值得关心。他们宁愿#cr#与世隔绝#ec#。\n\n正是出于这个原因，我会告诉你怎样找到我的家园。你已经证明了自己#cg#无可估量#ec#，充满力量、智慧，而又狡猾。\n\n你可以挑战#co#诸神领域#ec#，#cg#赢得胜利#ec#。\n
exp_wanderer_realmofgods_continue_4	#cy#？？？流浪者#ec#：简言之，是的。只有这样，他们才会#cy#相信你的潜力#ec#，重燃对外面世界的兴趣。你所能做到的一定比我能说的还要有效。\n\n一旦我透露了通往我家园的道路，你将#cy#来去自如#ec#。但你可以想象，你的到来将不会受到#cg#款待#ec#。\n\n你可能会与一些你从未面对过、#cr#最强大的生物#ec#进行战斗。\n
exp_wanderer_realmofgods_continue_5	#cy#？？？流浪者#ec#：我就知道你会这么说，探索者。很好！通往#co#诸神领域#ec#的道路即将揭晓。\n\n返回你击败#cc#萨拉#ec#的地方，你会在那里找到入口。\n\n
exp_wanderer_realmofgods_continue_responsebutton_1	你太美了！
exp_wanderer_realmofgods_continue_responsebutton_2	你是指，他们不离开自己的家园吗？
exp_wanderer_realmofgods_continue_responsebutton_3	你想让我和你的同类战斗？！
exp_wanderer_realmofgods_continue_responsebutton_4	我已经付出努力来到这里，相信我也能解决他们！
exp_wanderer_realmofgods_intro_1	#cy#？？？流浪者#ec#：你已亲眼瞥见在纷乱深渊之外的大地了，对吧？\n\n我能#cg#感觉#ec#到。\n
exp_wanderer_realmofgods_intro_2	#cy#？？？流浪者#ec#：我知道。你是一名#cy#探索者#ec#，当探索者到达一个目的地时，他们总是准备好寻找下一个目的地。\n\n最终，你会对所看见的这片大地有更深入的了解，你的冒险将总有一天会继续，你也终将回答自己心中的问题。\n\n但是，#cy#纷乱深渊#ec#的#cg#最后一个秘密#ec#仍未被发现。\n
exp_wanderer_realmofgods_intro_3	#cy#？？？流浪者#ec#：我来自#cg#纷乱深渊#ec#和上方#cy#无尽大地#ec#的边界。这领域很早就存在于世界上了；是谁创造的？我也不知道。\n\n#cr#威武野兽#ec#、#cc#远古鬼灵#ec#及拥有无限力量的#cs#机器人#ec#都居住在那儿。这很难以想象，对吧？所有这些生物和谐共处，把这里称为家园。\n\n我们用#cy#失传的语言#ec#称呼着这片大地。在你的语言中，你可以称它为#co#诸神领域#ec#。\n
exp_wanderer_realmofgods_intro_4	#cy#？？？流浪者#ec#：当然，我会告诉你的。但首先，你必须要有更多了解。我还没有完全坦白……\n\n事实上，我是一个#cc#远古鬼灵#ec#。让我显现给你看。\n
exp_wanderer_realmofgods_intro_responsebutton_1	是的！真是让我叹为观止。我心里有好多问题想问……
exp_wanderer_realmofgods_intro_responsebutton_2	什么样的秘密？真的还有秘密吗？
exp_wanderer_realmofgods_intro_responsebutton_3	我要怎么去那儿？
exp_wanderer_realmofgods_intro_responsebutton_4	！！！
exp_wanderer_selectdungeon_confirm	开始此旅途
exp_wanderer_selectdungeon_no	返回
exp_weaponmaster_statue_name	武器大师的雕像
exp_weaponmaster_statue_text	这是一个精通所有武器和战斗技巧的#cy#强大武士#ec#的雕像。\n\n这里有一个仁善的光环弥漫着#cc#原能#ec#，好像他想把#cg#他知识的碎片#ec#传授给我。\n\n我应该在这里冥想吗？\n
glitterskin_status_desc	Melee attackers will be blinded, losing ^number1^ Accuracy for ^number2^ turns
intro_dualwielder	羽毛笔和墨水是所有故事的精髓。\n一笔一划，或遒劲或飘逸，\n我的艺术与我的道路浑然一体。\n今天就如一块空白的画布。
item_armor_heavyarmor5_desc	这套盔甲实在是太……精细了。被擦的如此的闪耀。很明显它还没经历过任何战斗，它恐怕只能在一些特殊的场合穿吧。
item_armor_heavyarmor5_name	礼仪铠甲
item_armor_lightarmor5_desc	穿上这件披风后，我仿佛感觉到一个守卫在留心着我的每一步。每当我要摔倒时，它会及时帮我平衡身体。谁能想到会有如此牢固而又轻盈的披风？
item_armor_lightarmor5_name	神秘披风
item_armor_mediumarmor5_desc	这些秘银环如此闪耀，就像我穿着一件闪闪发光的裙子一样！但是和绝大多数裙子不同的是，它能保护我。真棒！
item_armor_mediumarmor5_name	秘银锁甲
item_armor_shield6_desc	我记得我曾经从一本书上看到过一次这种盾徽的图。它来自一个神话中的国家，长者告诉我这仅仅是一个传说。即使是这样，我还是相信它是真实存在的！
item_armor_shield6_name	皇家盾牌
item_bomb_confusetraps_desc	我听说曾经有一些这样的盒子在围栏附近被打卡，结果花了杰西一整天时间去抓捕怪兽。
item_bomb_confusetraps_effectdesc	放置一个当怪物踩上去会散发出令其迷失方向的陷阱！陷阱会持续^number1^回合，会使怪物混乱^number2^回合。
item_bomb_confusetraps_name	混乱陷阱
item_item_gem8_desc	不知道为什么，这玩意在溪石非常受欢迎。它既不坚硬，又不像金子一样闪闪发光，它很重！
item_item_gem9_desc	这是纷乱深渊中最坚硬的宝石。如果不是他们如此稀有和值钱，我一定用它们像石头一样砸向当在我路上的怪物。
item_weapon_2hsword6_desc	即使经验再丰富的士兵在这把剑的面前也会被突破防线。我需要变得更勇敢这样才能不负这把剑的传奇。
item_weapon_2hsword6_name	巴斯特之剑
item_weapon_axe6_desc	我想了一下，难道能用黄金做的武器来购买东西吗？是多富有的人才会做出这样的东西？我下次要去问问猫娘。
item_weapon_axe6_name	奥勒斧
item_weapon_bow6_desc	当我拿着这把弓瞄准时，我能感受到一股仁善的气息在引导着我。即使我在发射致命的射弹，这依然令人感到舒适。
item_weapon_bow6_name	天使之弓
item_weapon_claw6_desc	这究竟是是多么巨大的一个怪物才能拥有一个这样大的尖牙！我不希望看到这个怪物，我更不希望看到把这个怪物的牙齿弄下来的人。
item_weapon_claw6_name	原始之牙
item_weapon_dagger6_desc	我从未想过我会习惯于被自己武器窥视的感觉。特别是每当我攻击未命中时，这种感觉愈发强烈。
item_weapon_dagger6_name	噩梦长钉
item_weapon_mace6_desc	这是真是一个残暴的东西，不需要任何技巧来使用它。见到一个这样的武器心中只有一个句话“粉碎一切！”
item_weapon_mace6_name	法兰粉碎者
item_weapon_spear6_desc	简单地把一块红布绑在矛上竟然能让它看起来如此时尚。但我想知道探险者用它战斗的时候，会有多少次因为不小心踩到它而被绊倒。
item_weapon_spear6_name	戟
item_weapon_staff6_desc	自从我拿到这个长杖以来，我所有的睡梦都变得更舒适，我醒来后也会感到神清气爽。它就像一盏能安抚我灵魂的明灯。
item_weapon_staff6_name	泛光杖
item_weapon_sword0_desc	墨水是书法家生命的命脉，羊皮纸上的每一个标记都是他生命的延伸。我努力地去了解、学习，现在是时候让我把自己书写在历史的绘卷中。
item_weapon_sword0_name	研学之笔
item_weapon_sword6_desc	我始终对这把剑的轻盈和平衡感到敬畏。拿着这把剑就像拿着一个梦，一个能将怪物从它们站的位置劈开的梦。
item_weapon_sword6_name	神圣之剑
lightningdebuff30_name	电属性易伤
log_bankrelic	你放下了圣物：^tag1^。\n\n若你取得胜利，它将出现在#cy#银行#ec#里！\n\n
log_error_know_skill	你#cr#已经学会了#ec#那个技能了！
log_keeprelic	你保留了圣物：^tag1^。\n\n它将在旅途结束时消失。\n\n
log_mon_terrain_power	#cy#^tag2^#ec#环境下的#cy#^tag1^#ec#变得#cg#更加强大了#ec#！
log_monster_died_shara	^tag1^被打败了！获得了<color=#40b843>^tag2^</color>点职业点数和<color=yellow>^tag3^</color>枚金币！
log_oilslick_poison_damage_up	<color=yellow>浮油会造成毒属性伤害！</color>
log_robot_summon	#cy#^tag1^#ec#用破铜烂铁组装出另一个#cy#^tag1^#ec#！
log_shara_creatureheal	你能从你所#cc#操控的#ec#生物获得#cy#^tag1^#ec#生命！
log_shara_maxcreatures	你#cr#无法再控制#ec#任何生物（最大值：#cy#^tag1^#ec#）
log_shield_absorb_damage_attack	<color=#ffc80a>^tag1^</color>对<color=#ffc80a>^tag3^</color>造成了#co#^tag2^#ec#伤害！（#cc#护盾吸收！#ec#）
log_shield_absorb_damage_effect	<color=#ffc80a>^tag1^</color>通过#cy#^tag4^#ec#对<color=#ffc80a>^tag3^</color>造成了#co#^tag2^#ec#伤害！（#cc#护盾吸收！#ec#）
md_items_breakables	#cc#特殊状况#ec#：从可破坏物体中获得的物品增加！
md_jp_only_campfires	#cc#特殊状况#ec#：只能在篝火处获得职业点数！
md_keepgold_items_relics	#cy#成功后#ec#：保留所有#cy#金币#ec#、#cg#物品#ec#和至少一件地下城中获得的#clr#遗物#ec#。
md_keepgold_relics	#cy#成功后#ec#：保留所有#cy#金币#ec#、#cg#物品#ec#和至少一件地下城中获得的#clr#遗物#ec#。
md_keeprelics	#cy#成功后#ec#：保留至少一件地下城中获得的#clr#遗物#ec#。
md_king_chaser	#cc#特殊状况#ec#：#clr#神秘的王#ec#会从一开始就来追捕你！
md_lowmonsteraggro	#cc#特殊状况#ec#：怪物们会更加温和！
md_many_champions	#cc#特殊状况#ec#：普通怪变少，精英怪变多！
md_mini_dreamcaster_explain_text	#cy#迷你梦境仪#ec#：使用说明如下。\n\n插入#cy#装备#ec#、#cc#梦幻宝珠#ec#，以及#co#金币#ec#到单位中。\n\n装备将会升级。如有可能，可以添加一个额外的#co#魔法改造符#ec#。\n\n#cy#迷你梦境仪#ec#一经使用后#cr#便#ec#自毁。\n
md_mini_dreamcaster_main_response0	你真可爱！你有什么用处？
md_mini_dreamcaster_main_response1	升级我的防具！
md_mini_dreamcaster_main_text	#cy#迷你梦境仪#ec#：#cg#当前状态：小巧又可运行。#ec#\n
md_mini_dreamcaster_orbselect_text	#cy#迷你梦境仪#ec#：请选择要使用的#cy#梦幻宝珠#ec#。选择#cc#透明宝珠#ec#或#cg#技能宝珠#ec#将赋予你附在该宝珠上的魔法改造符。\n
md_mini_dreamcaster_upgrade_text	#cy#迷你梦境仪#ec#：请选择装备升级。所有升级需要一个#cy#梦幻宝珠#ec#。\n\n你可以在选择装备后选择宝珠。\n\n#cy#警告：迷你梦境仪单位可能只能使用一次。随后#ec##cr#它会自毁#ec#。\n
md_monster_powerup	#cc#特殊状况#ec#：怪物们会互相攻击。在它们击杀了其他怪物后，它们会升级！
md_monsters_respawn	#cc#特殊状况#ec#：怪物会复活！
md_more_consumables	#cc#特殊状况#ec#：消耗品出现概率上升！
md_nodrops	#cc#特殊状况#ec#：怪物不会掉落物品和装备！
md_ondefeat_loseprogress	#cy#失败后#ec#：失去该地下城获得的一切
md_randomshop_intro_txt	#cy#^$npcname:current$^:#ec#你好！有兴趣看一眼这些#cc#好东西#ec#吗？食物、武器、盔甲或者一些小玩意儿，只要你能说出名字的，我这都有\n
md_shopkeepers	#cc#特殊状况#ec#：商人会在每层楼出现！
md_startwithnothing	#cy#初始条件#ec#：从没有装备、技能、宠物和背包的1级开始
misc_scaryface	恐怖的脸！
misc_shape_flexrect	Rectangle
misc_shape_semicircle	半圆
mm_dualwielderemblem_tier0_biography_desc	拾取你的战斗传记可获得^number1^闪避率，持续^number2^回合
mm_dualwielderemblem_tier0_dualwield_desc	双持武器时，基础攻击造成^number1^伤害
mm_dualwielderemblem_tier1_glide_desc	使用滑行时，可获得一个笔划
mm_dualwielderemblem_tier1_shadow_desc	暗属性伤害能穿透^number1^敌人抗性
mm_dualwielderemblem_tier2_brush_desc	移动时，有^number1^几率获得一个笔划
mm_dualwielderemblem_tier2_dodge_desc	闪避时，所有技能冷却时间减少^number1^回合。
mm_elemental_bolt_desc	元素怒火
mm_elemental_bolt_name	使用伤害性元素技能时：有^number1^几率对随机敌人造成与上次技能相同属性的^number2^精神力伤害。
mm_elemental_bolt2_name	元素箭
modedescription_adventure_shara	<color=#40b843>冒险模式</color>\n如果你的生命值为0，你将<color=#40b843>返回萨拉营地</color>。\n你将损失一半的金钱和未使用的职业点数。\n推荐<color=#40b843>地牢探索类游戏新手</color>选择。\n\n
modedescription_heroic_shara	\n<color=#ffc80a>英雄模式</color>\n如果你的生命值为0，游戏将会结束（<color=red>永久死亡</color>）。\n<color=#ffc80a>极具挑战性</color>，但这是<color=yellow>体验“萨拉的故事”的最佳方式</color>！\n\n
mon_voidcrystal_name	虚空水晶
monster_attr_liveinwater	水生型
mysteryking_chaser_powerup_txt	正追逐你的#clr#~ 神秘的王 ~#ec#释放出它所有的力量！\n\n准备面对#cy#真正的战斗#ec#……
npc_jumpintoriver_name	去溪石营地的水路
obj_holyfire_name	天国之焰
relic_flavor_no_owner	神秘的英雄
relic_option_goback	再次查看#cy#原有物品#ec#
relic_option_keep	在此旅途中保留圣物。旅途结束时圣物将#cr#消失#ec#。
relic_option_wait	成功完成旅途#cy#后#ec#可获得圣物。圣物等级与你进入旅途前的等级#cg#成正比#ec#。
relic_tutorial_text	#clr#圣物#ec#是随机生成的强大装备，各拥有其独特效果。它们甚至可能比#co#传奇#ec#和#cg#套装#ec#道具更强大！#clr#圣物#ec#只能通过在#cy#流浪者旅途#ec#中发现以获取。\n\n在#clr#旅途#ec#中打败最终头目#cy#神秘的王#ec#，保证能找到一个#clr#圣物#ec#。不过，你有时候也能在地下城的其他地方找到圣物。\n\n
relic_tutorial_text2	若是在遇到头目前发现#clr#圣物#ec#，你可以选择：在余下的#cy#旅途#ec#中使用#clr#圣物#ec#（但这会使圣物在旅途结束后#cr#消失#ec#），或在取得胜利后领取其作为#cg#奖励#ec#。\n\n如果你选择#cy#奖励#ec#，圣物等级将与你在旅途外的等级和该旅途的难度成正比。\n\n谨慎地作出选择！在地下城中你可能需要#clr#圣物#ec#的力量，但这样一来，在旅途结束后你将#cr#无法保留#ec#该圣物。如果你选择奖励，就只有取得#cg#胜利#ec#后才能获得圣物。\n\n
shadowdebuff30_name	暗属性易伤
shara_ability_update_text	你的#cc#目标#ec#完成了！#cy#^$sharamode:prevdominatename$^#ec#升级成了#cc#^$sharamode:dominatename$^#ec#。\n\n^$sharamode:dominatedesc$^\n\n
shara_ability_update_text_addendum	<size=46>精通支配！</size>\n\n现在你的#cc#支配#ec#技能将使处于你控制下的所有生物#cr#持续失去生命值#ec#，而不再逐渐恢复你的生命值。\n\n每当你#cy#打败#ec#一只#cc#受支配的#ec#重要怪物时，可恢复#cg#15%#ec#的最大生命值、体力和能量！\n\n
shara_stat_boost_counter	（购买数量： ^tag1^)）
skill_expmon_absorbpowerups_name	增益物品吸收
skill_expmon_adhesivetongue_name	黏腻舌头
skill_expmon_batterup_name	击球员就位！
skill_expmon_boulder_slam	湿地粉碎
skill_expmon_burstgas	剧毒爆发
skill_expmon_burstgas_name	毒爆
skill_expmon_cannonstunner_name	加农美人
skill_expmon_cubeslimesummonreaction_name	方型史莱姆分身
skill_expmon_divinepower_name	天国光环
skill_expmon_eatweapon_name	武器吞噬
skill_expmon_fireball_name	火焰箭
skill_expmon_fly2_name	翱翔
skill_expmon_glitterskin_name	闪光皮肤
skill_expmon_healovertime_name	再生
skill_expmon_holystorm_name	神圣风暴
skill_expmon_icepotion_name	霜冻药剂
skill_expmon_megabolt_name	雷霆一击
skill_expmon_mudfighter_name	泥巴战士
skill_expmon_multibite_name	啃噬风暴
skill_expmon_passive_dodge25	灵活闪避
skill_expmon_passive_dodge25_name	闪避率上升
skill_expmon_passivescare_name	恐怖的脸
skill_expmon_resilient_name	坚韧
skill_expmon_slimehex_name	终极诅咒
skill_expmon_staffcharge_name	当头棒喝
skill_expmon_stagrush_name	雄鹿冲击
skill_expmon_statusresist50_name	异常抗性
skill_expmon_stealandeatfood_name	大快朵颐
skill_expmon_stickyshot_name	黏腻射击
skill_expmon_transferhealth_name	生命值转移
skill_expmon_waterfighter_name	水的战士
skill_expmon_wingslash_name	翼斩
skill_noroot_nostun_name	眩晕抵抗
skill_playerglitterskin_desc	Surrounds you and your allies with glittering skin for ^number1^ turns! Striking the Glitterskin in melee range will blind attackers.
skill_playerglitterskin_edesc	Blinded attackers lose ^number2^ Accuracy for ^number3^ turns
skill_playerspinblade_desc	Creates four spinning blades that move away from you and cause damage each turn. Briefly increases your Parry chance.
skill_playerspinblade_edesc	Blades deal ^number1^ of Weapon Damage as Physical. Parry chance is increased by ^number2^ for ^number3^ turns.
skill_playerspitice_desc	Spit a shard of ice at a monster, dealing more damage the further away you are. Briefly raises your Spirit Power.
skill_playerspitice_edesc	Damage: ^number1^ of Spirit Power as Water. Deals ^number2^ extra damage for each tile between you and the target. Raises your Spirit Power by ^number3^ for ^number4^ turns.
skill_summonvoidcrystal_desc	召唤一个在消失前能长距离攻击两次的虚空水晶。
skill_summonvoidcrystal_extradesc	根据你的等级，一次可能召唤多个虚空水晶。
skill_xp_bladefroghop_name	布雷德跳
tutorial_exp_campfire_text	在#cc#萨拉的战役#ec#中，你每#cc#三层#ec#就能找到一个#cy#篝火#ec#。这是回复、学习新#cc#能力#ec#和购买#cy#道具#ec#的机会。\n\n在这些短暂的休息机会中规划好你的冒险吧！\n\n
tutorial_exp_sharamode_maxcreatures_text	萨拉的#cc#^$getstring:sharaabilityname$^#ec#技能一次只能控制#cy#limited number#ec#个生物。如果你已经控制了#cy#^$getstring:sharamaxcreatures$^#ec#个生物，你将不能再魅惑一个新的。\n\n然而，这项技能会随着故事的推动不断#cc#升级#ec#！在经历了主要的故事事件后，别忘记来看技能是否升级。\n\n
tutorial_exp_sharamode_part1_text	欢迎来到#cc#萨拉的战役#ec#。在这个游戏中，你将以全新的视角来体验#cg#纷乱深渊#ec#的故事，来获得一段不一样的游戏体验。如果你还未打通过主线游戏的#cy#第三个头目怪物#ec#，我们推荐你先去打通它！\n\n在这个模式中，你将不再拥有#cg#治疗瓶#ec#。作为替代，你在踏入喷泉时会回复你的状态。同样，你无法再访问#cy#溪石营地#ec#，你的#cy#传送#ec#只能用于快速旅行。\n\n这意味着，这里没有梦境仪、魔法树林和围栏……\n
tutorial_exp_sharamode_part2_text	萨拉不能获得#cy#经验#ec#，也不能用#cg#职业点数#ec#来学习技能。作为替代，你可以在技能页面用#cg#职业点数#ec#来购买永久性的状态强化，强化的费用每次都会增加。\n\n现在有两种学习技能的方法。你可以通过打开#cy#潘多拉魔盒#ec#来学习其他职业的技能，你可以从随机出现的两个技能中选择一个。\n\n你也可以在篝火休息时学习一个独特的#cc#萨拉#ec#专属技能！谨慎地作出你的每次选择，他们#cy#在每次游戏中都会不一样#ec#。\n\n
tutorial_exp_sharamode_wanderingmon_text	随着#cy#萨拉#ec#的力量不断增长和名气变大，#cg#纷乱深渊#ec#的生物会避开他！当你在#cy#任何一层#ec#展示了强大的力量并击败了足够多的怪物后，那里将#cr#不会出现#ec#新的怪物了。\n\n
wanderer_intro_1	#cy#？？？流浪者#ec#：噢，没错没错。但我只不过是随#cc#波#ec#逐流。\n\n你就不一样了……你懂得#cy#开拓属于自己的道路#ec#。比起漫无目的地四处漂泊，你宁愿逆流而行。\n\n我说的没错吧？\n
wanderer_intro_2	#cy#？？？流浪者#ec#：像我一样古老的灵魂已经看遍沧海桑田。我能告诉你这片大地的很多故事，#cg#远早于纷乱深渊的故事#ec#。\n\n但你必须全身心沉浸在故事中！\n\n在你的心灵随旅途荡漾时，你的身体也可随之而行。迎接新的体验吧，无尽的#cc#探索之海#ec#正在前方等着你。\n
wanderer_intro_3	#cy#？？？流浪者#ec#：我所能告诉你的就只有故事，探索者。如果你准备好#cy#开阔眼界#ec#，我会告诉你一个故事。\n\n如果你有所怀疑，你就不能做到#cy#真正的全身心沉浸#ec#，那我就无法带你进入这趟旅途了。\n\n在这当中，你可能甚至会发现自己没有任何#cg#装备、技能、宠物或道具#ec#。你准备好#cy#听我的故事了吗#ec#？\n
wanderer_intro_4	#cy#？？？流浪者#ec#：啊，你来了！在我的故事里你#cy#陷入了恍惚#ec#。对于全身心#cy#沉浸#ec#在一个好故事中的人来说，这并不稀奇。\n\n由于我们还没结束，我们会重新再来一遍。当然，细节#cy#每次都在变化#ec#，所以永远不可能有完全准备好的情况。\n\n你准备好了吗？\n
wanderer_intro_5	#cy#？？？流浪者#ec#：很好！我会告诉你#clr#高山坡路#ec#的故事。\n\n你会发现自己处在一场美妙旅途的开端，#cy#充满你从未见过的生物#ec#。价值不菲的#clr#圣物#ec#坐落在力量高峰，萦绕着呼啸狂风。\n\n就是那。闭上眼睛，#cg#听我的话#ec#……\n\n
wanderer_intro_response1	作为一名渔夫，你很有智慧。
wanderer_intro_response2	你曾到过在纷乱深渊之外的大地？！那里有着什么？
wanderer_intro_response3	等等，我还有别的事情要做。
wanderer_intro_response4	我准备好了。请告诉我！
waterdebuff30_name	水属性易伤
xp_obj_staticparalyzer_name	电能
exp1_obj_dominator_head_name	战利勋章